Trans. Date,Debits,Credits,Balance,Date,Day_of_week,Month,Month_name
2021-06-01,0.0,23125.0,30543.27,2021-06-01,Tuesday,6,Jun
2021-06-01,500.0,0.0,30043.27,2021-06-01,Tuesday,6,Jun
2021-06-01,1000.0,0.0,29043.27,2021-06-01,Tuesday,6,Jun
2021-06-01,10.0,0.0,29033.27,2021-06-01,Tuesday,6,Jun
2021-06-01,0.75,0.0,29032.52,2021-06-01,Tuesday,6,Jun
2021-06-01,50.0,0.0,28982.52,2021-06-01,Tuesday,6,Jun
2021-06-02,1200.0,0.0,27782.52,2021-06-02,Wednesday,6,Jun
2021-06-02,594.0,0.0,27188.52,2021-06-02,Wednesday,6,Jun
2021-06-02,663.94,0.0,26524.58,2021-06-02,Wednesday,6,Jun
2021-06-03,1500.0,0.0,25024.58,2021-06-03,Thursday,6,Jun
2021-06-03,10.0,0.0,25014.58,2021-06-03,Thursday,6,Jun
2021-06-03,0.75,0.0,25013.83,2021-06-03,Thursday,6,Jun
2021-06-03,3080.0,0.0,21933.83,2021-06-03,Thursday,6,Jun
2021-06-03,5000.0,0.0,16933.83,2021-06-03,Thursday,6,Jun
2021-06-03,10.0,0.0,16923.83,2021-06-03,Thursday,6,Jun
2021-06-03,0.75,0.0,16923.08,2021-06-03,Thursday,6,Jun
2021-06-03,3000.0,0.0,13923.08,2021-06-03,Thursday,6,Jun
2021-06-03,10.0,0.0,13913.08,2021-06-03,Thursday,6,Jun
2021-06-03,0.75,0.0,13912.33,2021-06-03,Thursday,6,Jun
2021-06-03,2100.0,0.0,11812.33,2021-06-03,Thursday,6,Jun
2021-06-03,10.0,0.0,11802.33,2021-06-03,Thursday,6,Jun
2021-06-03,0.75,0.0,11801.58,2021-06-03,Thursday,6,Jun
2021-06-03,1100.0,0.0,10701.58,2021-06-03,Thursday,6,Jun
2021-06-03,5000.0,0.0,5701.58,2021-06-03,Thursday,6,Jun
2021-06-03,0.0,15732.0,21433.58,2021-06-03,Thursday,6,Jun
2021-06-03,50.0,0.0,21383.58,2021-06-03,Thursday,6,Jun
2021-06-04,5000.0,0.0,16383.58,2021-06-04,Friday,6,Jun
2021-06-04,10.0,0.0,16373.58,2021-06-04,Friday,6,Jun
2021-06-04,0.75,0.0,16372.83,2021-06-04,Friday,6,Jun
2021-06-04,1100.0,0.0,15272.83,2021-06-04,Friday,6,Jun
2021-06-04,2000.0,0.0,13272.83,2021-06-04,Friday,6,Jun
2021-06-04,10.0,0.0,13262.83,2021-06-04,Friday,6,Jun
2021-06-04,0.75,0.0,13262.08,2021-06-04,Friday,6,Jun
2021-06-04,0.0,5000.0,18262.08,2021-06-04,Friday,6,Jun
2021-06-04,0.0,8500.0,26762.08,2021-06-04,Friday,6,Jun
2021-06-05,2500.0,0.0,24262.08,2021-06-05,Saturday,6,Jun
2021-06-05,10.0,0.0,24252.08,2021-06-05,Saturday,6,Jun
2021-06-05,0.75,0.0,24251.33,2021-06-05,Saturday,6,Jun
2021-06-05,300.0,0.0,23951.33,2021-06-05,Saturday,6,Jun
2021-06-09,8678.25,0.0,15273.08,2021-06-09,Wednesday,6,Jun
2021-06-09,10215.0,0.0,5058.08,2021-06-09,Wednesday,6,Jun
2021-06-09,0.0,100000.0,105058.08,2021-06-09,Wednesday,6,Jun
2021-06-09,50.0,0.0,105008.08,2021-06-09,Wednesday,6,Jun
2021-06-10,50000.0,0.0,55008.08,2021-06-10,Thursday,6,Jun
2021-06-10,25.0,0.0,54983.08,2021-06-10,Thursday,6,Jun
2021-06-10,1.87,0.0,54981.21,2021-06-10,Thursday,6,Jun
2021-06-10,0.0,134400.0,189381.21,2021-06-10,Thursday,6,Jun
2021-06-10,10000.01,0.0,179381.2,2021-06-10,Thursday,6,Jun
2021-06-10,125000.0,0.0,54381.2,2021-06-10,Thursday,6,Jun
2021-06-10,50.0,0.0,54331.2,2021-06-10,Thursday,6,Jun
2021-06-11,35200.0,0.0,19131.2,2021-06-11,Friday,6,Jun
2021-06-11,1000.0,0.0,18131.2,2021-06-11,Friday,6,Jun
2021-06-11,3000.0,0.0,15131.2,2021-06-11,Friday,6,Jun
2021-06-11,10.0,0.0,15121.2,2021-06-11,Friday,6,Jun
2021-06-11,0.75,0.0,15120.45,2021-06-11,Friday,6,Jun
2021-06-11,400.0,0.0,14720.45,2021-06-11,Friday,6,Jun
2021-06-11,10.0,0.0,14710.45,2021-06-11,Friday,6,Jun
2021-06-11,0.75,0.0,14709.7,2021-06-11,Friday,6,Jun
2021-06-12,1600.0,0.0,13109.7,2021-06-12,Saturday,6,Jun
2021-06-12,10000.0,0.0,3109.7,2021-06-12,Saturday,6,Jun
2021-06-12,0.0,30000.0,33109.7,2021-06-12,Saturday,6,Jun
2021-06-12,600.0,0.0,32509.7,2021-06-12,Saturday,6,Jun
2021-06-12,10.0,0.0,32499.7,2021-06-12,Saturday,6,Jun
2021-06-12,0.75,0.0,32498.95,2021-06-12,Saturday,6,Jun
2021-06-12,50.0,0.0,32448.95,2021-06-12,Saturday,6,Jun
2021-06-13,600.0,0.0,31848.95,2021-06-13,Sunday,6,Jun
2021-06-13,1000.0,0.0,30848.95,2021-06-13,Sunday,6,Jun
2021-06-13,10.0,0.0,30838.95,2021-06-13,Sunday,6,Jun
2021-06-13,0.75,0.0,30838.2,2021-06-13,Sunday,6,Jun
2021-06-14,100.0,0.0,30738.2,2021-06-14,Monday,6,Jun
2021-06-14,30000.0,0.0,738.2,2021-06-14,Monday,6,Jun
2021-06-14,700.0,0.0,38.2,2021-06-14,Monday,6,Jun
2021-06-14,0.0,6750.0,6788.2,2021-06-14,Monday,6,Jun
2021-06-14,6000.0,0.0,788.2,2021-06-14,Monday,6,Jun
2021-06-14,25.0,0.0,763.2,2021-06-14,Monday,6,Jun
2021-06-14,1.87,0.0,761.33,2021-06-14,Monday,6,Jun
2021-06-14,500.0,0.0,261.33,2021-06-14,Monday,6,Jun
2021-06-15,100.0,0.0,161.33,2021-06-15,Tuesday,6,Jun
2021-06-15,0.0,4672.8,4834.13,2021-06-15,Tuesday,6,Jun
2021-06-15,0.0,1100.0,5934.13,2021-06-15,Tuesday,6,Jun
2021-06-15,5000.0,0.0,934.13,2021-06-15,Tuesday,6,Jun
2021-06-15,10.0,0.0,924.13,2021-06-15,Tuesday,6,Jun
2021-06-15,0.75,0.0,923.38,2021-06-15,Tuesday,6,Jun
2021-06-16,300.0,0.0,623.38,2021-06-16,Wednesday,6,Jun
2021-06-16,150.0,0.0,473.38,2021-06-16,Wednesday,6,Jun
2021-06-16,0.0,300000.0,300473.38,2021-06-16,Wednesday,6,Jun
2021-06-16,1300.0,0.0,299173.38,2021-06-16,Wednesday,6,Jun
2021-06-16,10.0,0.0,299163.38,2021-06-16,Wednesday,6,Jun
2021-06-16,0.75,0.0,299162.63,2021-06-16,Wednesday,6,Jun
2021-06-16,298000.0,0.0,1162.63,2021-06-16,Wednesday,6,Jun
2021-06-16,300.0,0.0,862.63,2021-06-16,Wednesday,6,Jun
2021-06-16,50.0,0.0,812.63,2021-06-16,Wednesday,6,Jun
2021-06-17,0.0,40000.0,40812.63,2021-06-17,Thursday,6,Jun
2021-06-17,0.0,26400.0,67212.63,2021-06-17,Thursday,6,Jun
2021-06-17,200.0,0.0,67012.63,2021-06-17,Thursday,6,Jun
2021-06-17,0.0,4000.0,71012.63,2021-06-17,Thursday,6,Jun
2021-06-18,440.0,0.0,70572.63,2021-06-18,Friday,6,Jun
2021-06-18,200.0,0.0,70372.63,2021-06-18,Friday,6,Jun
2021-06-18,0.0,320000.0,390372.63,2021-06-18,Friday,6,Jun
2021-06-18,200.0,0.0,390172.63,2021-06-18,Friday,6,Jun
2021-06-18,1000.0,0.0,389172.63,2021-06-18,Friday,6,Jun
2021-06-18,380000.0,0.0,9172.63,2021-06-18,Friday,6,Jun
2021-06-18,50.0,0.0,9122.63,2021-06-18,Friday,6,Jun
2021-06-18,3.75,0.0,9118.88,2021-06-18,Friday,6,Jun
2021-06-18,50.0,0.0,9068.88,2021-06-18,Friday,6,Jun
2021-06-19,1000.0,0.0,8068.88,2021-06-19,Saturday,6,Jun
2021-06-19,4400.0,0.0,3668.88,2021-06-19,Saturday,6,Jun
2021-06-19,200.0,0.0,3468.88,2021-06-19,Saturday,6,Jun
2021-06-20,100.0,0.0,3368.88,2021-06-20,Sunday,6,Jun
2021-06-20,200.0,0.0,3168.88,2021-06-20,Sunday,6,Jun
2021-06-20,100.0,0.0,3068.88,2021-06-20,Sunday,6,Jun
2021-06-21,200.0,0.0,2868.88,2021-06-21,Monday,6,Jun
2021-06-21,200.0,0.0,2668.88,2021-06-21,Monday,6,Jun
2021-06-21,500.0,0.0,2168.88,2021-06-21,Monday,6,Jun
2021-06-21,2100.0,0.0,68.88,2021-06-21,Monday,6,Jun
2021-06-21,10.0,0.0,58.88,2021-06-21,Monday,6,Jun
2021-06-21,0.75,0.0,58.13,2021-06-21,Monday,6,Jun
2021-06-24,0.0,500000.0,500058.13,2021-06-24,Thursday,6,Jun
2021-06-25,50.0,0.0,500008.13,2021-06-25,Friday,6,Jun
2021-06-25,65000.0,0.0,435008.13,2021-06-25,Friday,6,Jun
2021-06-25,400000.0,0.0,35008.13,2021-06-25,Friday,6,Jun
2021-06-25,50.0,0.0,34958.13,2021-06-25,Friday,6,Jun
2021-06-25,3.75,0.0,34954.38,2021-06-25,Friday,6,Jun
2021-06-25,663.94,0.0,34290.44,2021-06-25,Friday,6,Jun
2021-06-25,700.0,0.0,33590.44,2021-06-25,Friday,6,Jun
2021-06-25,10.0,0.0,33580.44,2021-06-25,Friday,6,Jun
2021-06-25,0.75,0.0,33579.69,2021-06-25,Friday,6,Jun
2021-06-25,2100.0,0.0,31479.69,2021-06-25,Friday,6,Jun
2021-06-25,10.0,0.0,31469.69,2021-06-25,Friday,6,Jun
2021-06-25,0.75,0.0,31468.94,2021-06-25,Friday,6,Jun
2021-06-26,950.0,0.0,30518.94,2021-06-26,Saturday,6,Jun
2021-06-26,29000.0,0.0,1518.94,2021-06-26,Saturday,6,Jun
2021-06-26,25.0,0.0,1493.94,2021-06-26,Saturday,6,Jun
2021-06-26,1.87,0.0,1492.07,2021-06-26,Saturday,6,Jun
2021-06-28,0.0,1634.45,3126.52,2021-06-28,Monday,6,Jun
2021-06-28,0.0,2425.0,5551.52,2021-06-28,Monday,6,Jun
2021-06-28,0.0,23280.0,28831.52,2021-06-28,Monday,6,Jun
2021-06-28,500.0,0.0,28331.52,2021-06-28,Monday,6,Jun
2021-06-28,4070.0,0.0,24261.52,2021-06-28,Monday,6,Jun
2021-06-28,512.0,0.0,23749.52,2021-06-28,Monday,6,Jun
2021-06-28,38.4,0.0,23711.12,2021-06-28,Monday,6,Jun
2021-06-29,5000.0,0.0,18711.12,2021-06-29,Tuesday,6,Jun
2021-06-29,500.0,0.0,18211.12,2021-06-29,Tuesday,6,Jun
2021-06-29,0.0,28130.0,46341.12,2021-06-29,Tuesday,6,Jun
2021-06-29,45000.0,0.0,1341.12,2021-06-29,Tuesday,6,Jun
2021-06-29,25.0,0.0,1316.12,2021-06-29,Tuesday,6,Jun
2021-06-29,1.87,0.0,1314.25,2021-06-29,Tuesday,6,Jun
2021-06-29,100.0,0.0,1214.25,2021-06-29,Tuesday,6,Jun
2021-06-29,0.0,450000.0,451214.25,2021-06-29,Tuesday,6,Jun
2021-06-30,100.0,0.0,451114.25,2021-06-30,Wednesday,6,Jun
2021-06-30,1100.0,0.0,450014.25,2021-06-30,Wednesday,6,Jun
2021-06-30,1000.0,0.0,449014.25,2021-06-30,Wednesday,6,Jun
2021-06-30,10.0,0.0,449004.25,2021-06-30,Wednesday,6,Jun
2021-06-30,0.75,0.0,449003.5,2021-06-30,Wednesday,6,Jun
2021-06-30,100000.0,0.0,349003.5,2021-06-30,Wednesday,6,Jun
2021-06-30,500.0,0.0,348503.5,2021-06-30,Wednesday,6,Jun
2021-06-30,0.0,970000.0,1318503.5,2021-06-30,Wednesday,6,Jun
2021-06-30,400000.0,0.0,918503.5,2021-06-30,Wednesday,6,Jun
2021-06-30,50.0,0.0,918453.5,2021-06-30,Wednesday,6,Jun
2021-06-30,3.75,0.0,918449.75,2021-06-30,Wednesday,6,Jun
2021-06-30,5000.0,0.0,913449.75,2021-06-30,Wednesday,6,Jun
2021-06-30,700000.0,0.0,213449.75,2021-06-30,Wednesday,6,Jun
2021-06-30,50.0,0.0,213399.75,2021-06-30,Wednesday,6,Jun
2021-06-30,3.75,0.0,213396.0,2021-06-30,Wednesday,6,Jun
2021-06-30,100000.0,0.0,113396.0,2021-06-30,Wednesday,6,Jun
2021-06-30,50.0,0.0,113346.0,2021-06-30,Wednesday,6,Jun
2021-06-30,3.75,0.0,113342.25,2021-06-30,Wednesday,6,Jun
2021-06-30,11000.0,0.0,102342.25,2021-06-30,Wednesday,6,Jun
2021-06-30,25.0,0.0,102317.25,2021-06-30,Wednesday,6,Jun
2021-06-30,1.87,0.0,102315.38,2021-06-30,Wednesday,6,Jun
2021-06-30,10000.0,0.0,92315.38,2021-06-30,Wednesday,6,Jun
2021-06-30,25.0,0.0,92290.38,2021-06-30,Wednesday,6,Jun
2021-06-30,1.87,0.0,92288.51,2021-06-30,Wednesday,6,Jun
2021-07-01,500.0,0.0,91788.51,2021-07-01,Thursday,7,Jul
2021-07-01,80000.0,0.0,11788.51,2021-07-01,Thursday,7,Jul
2021-07-01,5038.0,0.0,6750.51,2021-07-01,Thursday,7,Jul
2021-07-01,0.0,200000.0,206750.51,2021-07-01,Thursday,7,Jul
2021-07-01,0.0,90000.0,296750.51,2021-07-01,Thursday,7,Jul
2021-07-01,290000.0,0.0,6750.51,2021-07-01,Thursday,7,Jul
2021-07-01,500.0,0.0,6250.51,2021-07-01,Thursday,7,Jul
2021-07-01,2100.0,0.0,4150.51,2021-07-01,Thursday,7,Jul
2021-07-01,20.0,0.0,4130.51,2021-07-01,Thursday,7,Jul
2021-07-01,1.5,0.0,4129.01,2021-07-01,Thursday,7,Jul
2021-07-01,500.0,0.0,3629.01,2021-07-01,Thursday,7,Jul
2021-07-01,1350.0,0.0,2279.01,2021-07-01,Thursday,7,Jul
2021-07-02,100.0,0.0,2179.01,2021-07-02,Friday,7,Jul
2021-07-02,0.0,30000.0,32179.01,2021-07-02,Friday,7,Jul
2021-07-03,50.0,0.0,32129.01,2021-07-03,Saturday,7,Jul
2021-07-03,1500.0,0.0,30629.01,2021-07-03,Saturday,7,Jul
2021-07-03,1500.0,0.0,29129.01,2021-07-03,Saturday,7,Jul
2021-07-03,10.0,0.0,29119.01,2021-07-03,Saturday,7,Jul
2021-07-03,0.75,0.0,29118.26,2021-07-03,Saturday,7,Jul
2021-07-03,1000.0,0.0,28118.26,2021-07-03,Saturday,7,Jul
2021-07-03,10.0,0.0,28108.26,2021-07-03,Saturday,7,Jul
2021-07-03,0.75,0.0,28107.51,2021-07-03,Saturday,7,Jul
2021-07-03,10000.0,0.0,18107.51,2021-07-03,Saturday,7,Jul
2021-07-03,25.0,0.0,18082.51,2021-07-03,Saturday,7,Jul
2021-07-03,1.87,0.0,18080.64,2021-07-03,Saturday,7,Jul
2021-07-03,200.0,0.0,17880.64,2021-07-03,Saturday,7,Jul
2021-07-03,15000.0,0.0,2880.64,2021-07-03,Saturday,7,Jul
2021-07-03,25.0,0.0,2855.64,2021-07-03,Saturday,7,Jul
2021-07-03,1.87,0.0,2853.77,2021-07-03,Saturday,7,Jul
2021-07-03,500.0,0.0,2353.77,2021-07-03,Saturday,7,Jul
2021-07-03,1500.0,0.0,853.77,2021-07-03,Saturday,7,Jul
2021-07-04,200.0,0.0,653.77,2021-07-04,Sunday,7,Jul
2021-07-06,0.0,30000.0,30653.77,2021-07-06,Tuesday,7,Jul
2021-07-06,12000.0,0.0,18653.77,2021-07-06,Tuesday,7,Jul
2021-07-06,25.0,0.0,18628.77,2021-07-06,Tuesday,7,Jul
2021-07-06,1.87,0.0,18626.9,2021-07-06,Tuesday,7,Jul
2021-07-07,17600.0,0.0,1026.9,2021-07-07,Wednesday,7,Jul
2021-07-07,200.0,0.0,826.9,2021-07-07,Wednesday,7,Jul
2021-07-08,200.0,0.0,626.9,2021-07-08,Thursday,7,Jul
2021-07-08,300.0,0.0,326.9,2021-07-08,Thursday,7,Jul
2021-07-09,0.0,10700.0,11026.9,2021-07-09,Friday,7,Jul
2021-07-09,5000.0,0.0,6026.9,2021-07-09,Friday,7,Jul
2021-07-09,10.0,0.0,6016.9,2021-07-09,Friday,7,Jul
2021-07-09,0.75,0.0,6016.15,2021-07-09,Friday,7,Jul
2021-07-09,200.0,0.0,5816.15,2021-07-09,Friday,7,Jul
2021-07-10,50.0,0.0,5766.15,2021-07-10,Saturday,7,Jul
2021-07-10,0.0,15000.0,20766.15,2021-07-10,Saturday,7,Jul
2021-07-10,14000.1,0.0,6766.05,2021-07-10,Saturday,7,Jul
2021-07-10,25.0,0.0,6741.05,2021-07-10,Saturday,7,Jul
2021-07-10,1.87,0.0,6739.18,2021-07-10,Saturday,7,Jul
2021-07-10,50.0,0.0,6689.18,2021-07-10,Saturday,7,Jul
2021-07-11,200.0,0.0,6489.18,2021-07-11,Sunday,7,Jul
2021-07-11,0.0,245000.0,251489.18,2021-07-11,Sunday,7,Jul
2021-07-11,245000.0,0.0,6489.18,2021-07-11,Sunday,7,Jul
2021-07-11,200.0,0.0,6289.18,2021-07-11,Sunday,7,Jul
2021-07-11,50.0,0.0,6239.18,2021-07-11,Sunday,7,Jul
2021-07-12,500.0,0.0,5739.18,2021-07-12,Monday,7,Jul
2021-07-12,5000.0,0.0,739.18,2021-07-12,Monday,7,Jul
2021-07-12,700.0,0.0,39.18,2021-07-12,Monday,7,Jul
2021-07-12,0.0,250000.0,250039.18,2021-07-12,Monday,7,Jul
2021-07-12,249950.0,0.0,89.18,2021-07-12,Monday,7,Jul
2021-07-12,50.0,0.0,39.18,2021-07-12,Monday,7,Jul
2021-07-13,0.0,500000.0,500039.18,2021-07-13,Tuesday,7,Jul
2021-07-13,499950.0,0.0,89.18,2021-07-13,Tuesday,7,Jul
2021-07-13,50.0,0.0,39.18,2021-07-13,Tuesday,7,Jul
2021-07-14,0.0,10500.0,10539.18,2021-07-14,Wednesday,7,Jul
2021-07-14,50.0,0.0,10489.18,2021-07-14,Wednesday,7,Jul
2021-07-15,200.0,0.0,10289.18,2021-07-15,Thursday,7,Jul
2021-07-15,0.0,1000.0,11289.18,2021-07-15,Thursday,7,Jul
2021-07-15,1700.0,0.0,9589.18,2021-07-15,Thursday,7,Jul
2021-07-15,10.0,0.0,9579.18,2021-07-15,Thursday,7,Jul
2021-07-15,0.75,0.0,9578.43,2021-07-15,Thursday,7,Jul
2021-07-15,0.0,4127.2,13705.63,2021-07-15,Thursday,7,Jul
2021-07-15,200.0,0.0,13505.63,2021-07-15,Thursday,7,Jul
2021-07-16,500.0,0.0,13005.63,2021-07-16,Friday,7,Jul
2021-07-16,9000.0,0.0,4005.63,2021-07-16,Friday,7,Jul
2021-07-17,1000.0,0.0,3005.63,2021-07-17,Saturday,7,Jul
2021-07-19,500.0,0.0,2505.63,2021-07-19,Monday,7,Jul
2021-07-19,200.0,0.0,2305.63,2021-07-19,Monday,7,Jul
2021-07-19,2100.0,0.0,205.63,2021-07-19,Monday,7,Jul
2021-07-19,10.0,0.0,195.63,2021-07-19,Monday,7,Jul
2021-07-19,0.75,0.0,194.88,2021-07-19,Monday,7,Jul
2021-07-20,100.0,0.0,94.88,2021-07-20,Tuesday,7,Jul
2021-07-22,0.0,247350.0,247444.88,2021-07-22,Thursday,7,Jul
2021-07-22,245000.0,0.0,2444.88,2021-07-22,Thursday,7,Jul
2021-07-22,50.0,0.0,2394.88,2021-07-22,Thursday,7,Jul
2021-07-22,3.75,0.0,2391.13,2021-07-22,Thursday,7,Jul
2021-07-22,700.0,0.0,1691.13,2021-07-22,Thursday,7,Jul
2021-07-22,10.0,0.0,1681.13,2021-07-22,Thursday,7,Jul
2021-07-22,0.75,0.0,1680.38,2021-07-22,Thursday,7,Jul
2021-07-22,1600.0,0.0,80.38,2021-07-22,Thursday,7,Jul
2021-07-22,10.0,0.0,70.38,2021-07-22,Thursday,7,Jul
2021-07-22,0.75,0.0,69.63,2021-07-22,Thursday,7,Jul
2021-07-22,50.0,0.0,19.63,2021-07-22,Thursday,7,Jul
2021-07-25,0.0,3000.0,3019.63,2021-07-25,Sunday,7,Jul
2021-07-25,200.0,0.0,2819.63,2021-07-25,Sunday,7,Jul
2021-07-25,0.0,10000.0,12819.63,2021-07-25,Sunday,7,Jul
2021-07-26,384.0,0.0,12435.63,2021-07-26,Monday,7,Jul
2021-07-26,200.0,0.0,12235.63,2021-07-26,Monday,7,Jul
2021-07-26,9000.0,0.0,3235.63,2021-07-26,Monday,7,Jul
2021-07-26,0.0,245885.3,249120.93,2021-07-26,Monday,7,Jul
2021-07-26,100.0,0.0,249020.93,2021-07-26,Monday,7,Jul
2021-07-26,200.0,0.0,248820.93,2021-07-26,Monday,7,Jul
2021-07-26,10000.0,0.0,238820.93,2021-07-26,Monday,7,Jul
2021-07-26,25.0,0.0,238795.93,2021-07-26,Monday,7,Jul
2021-07-26,1.87,0.0,238794.06,2021-07-26,Monday,7,Jul
2021-07-26,230000.0,0.0,8794.06,2021-07-26,Monday,7,Jul
2021-07-26,50.0,0.0,8744.06,2021-07-26,Monday,7,Jul
2021-07-26,3.75,0.0,8740.31,2021-07-26,Monday,7,Jul
2021-07-26,50.0,0.0,8690.31,2021-07-26,Monday,7,Jul
2021-07-27,700.0,0.0,7990.31,2021-07-27,Tuesday,7,Jul
2021-07-27,800.0,0.0,7190.31,2021-07-27,Tuesday,7,Jul
2021-07-27,1300.0,0.0,5890.31,2021-07-27,Tuesday,7,Jul
2021-07-27,0.0,190000.0,195890.31,2021-07-27,Tuesday,7,Jul
2021-07-27,50000.0,0.0,145890.31,2021-07-27,Tuesday,7,Jul
2021-07-27,25.0,0.0,145865.31,2021-07-27,Tuesday,7,Jul
2021-07-27,1.87,0.0,145863.44,2021-07-27,Tuesday,7,Jul
2021-07-27,140000.0,0.0,5863.44,2021-07-27,Tuesday,7,Jul
2021-07-27,50.0,0.0,5813.44,2021-07-27,Tuesday,7,Jul
2021-07-27,3.75,0.0,5809.69,2021-07-27,Tuesday,7,Jul
2021-07-27,500.0,0.0,5309.69,2021-07-27,Tuesday,7,Jul
2021-07-27,0.0,78497.25,83806.94,2021-07-27,Tuesday,7,Jul
2021-07-27,80000.0,0.0,3806.94,2021-07-27,Tuesday,7,Jul
2021-07-27,50.0,0.0,3756.94,2021-07-27,Tuesday,7,Jul
2021-07-27,3.75,0.0,3753.19,2021-07-27,Tuesday,7,Jul
2021-07-27,100.0,0.0,3653.19,2021-07-27,Tuesday,7,Jul
2021-07-28,0.0,34435.0,38088.19,2021-07-28,Wednesday,7,Jul
2021-07-28,50.0,0.0,38038.19,2021-07-28,Wednesday,7,Jul
2021-07-29,1400.0,0.0,36638.19,2021-07-29,Thursday,7,Jul
2021-07-29,10.0,0.0,36628.19,2021-07-29,Thursday,7,Jul
2021-07-29,0.75,0.0,36627.44,2021-07-29,Thursday,7,Jul
2021-07-29,200.0,0.0,36427.44,2021-07-29,Thursday,7,Jul
2021-07-29,5000.0,0.0,31427.44,2021-07-29,Thursday,7,Jul
2021-07-29,10.0,0.0,31417.44,2021-07-29,Thursday,7,Jul
2021-07-29,0.75,0.0,31416.69,2021-07-29,Thursday,7,Jul
2021-07-29,30000.0,0.0,1416.69,2021-07-29,Thursday,7,Jul
2021-07-29,25.0,0.0,1391.69,2021-07-29,Thursday,7,Jul
2021-07-29,1.87,0.0,1389.82,2021-07-29,Thursday,7,Jul
2021-07-29,0.0,26500.0,27889.82,2021-07-29,Thursday,7,Jul
2021-07-29,25000.0,0.0,2889.82,2021-07-29,Thursday,7,Jul
2021-07-29,25.0,0.0,2864.82,2021-07-29,Thursday,7,Jul
2021-07-29,1.87,0.0,2862.95,2021-07-29,Thursday,7,Jul
2021-07-29,2101.0,0.0,761.95,2021-07-29,Thursday,7,Jul
2021-07-29,10.0,0.0,751.95,2021-07-29,Thursday,7,Jul
2021-07-29,0.75,0.0,751.2,2021-07-29,Thursday,7,Jul
2021-07-29,0.0,121250.0,122001.2,2021-07-29,Thursday,7,Jul
2021-07-29,121000.0,0.0,1001.2,2021-07-29,Thursday,7,Jul
2021-07-29,50.0,0.0,951.2,2021-07-29,Thursday,7,Jul
2021-07-29,3.75,0.0,947.45,2021-07-29,Thursday,7,Jul
2021-07-29,200.0,0.0,747.45,2021-07-29,Thursday,7,Jul
2021-07-29,100.0,0.0,647.45,2021-07-29,Thursday,7,Jul
2021-07-30,200.0,0.0,447.45,2021-07-30,Friday,7,Jul
2021-07-30,300.0,0.0,147.45,2021-07-30,Friday,7,Jul
2021-07-30,100.0,0.0,47.45,2021-07-30,Friday,7,Jul
2021-07-31,0.0,100000.0,100047.45,2021-07-31,Saturday,7,Jul
2021-07-31,9960.0,0.0,90087.45,2021-07-31,Saturday,7,Jul
2021-07-31,25.0,0.0,90062.45,2021-07-31,Saturday,7,Jul
2021-07-31,1.87,0.0,90060.58,2021-07-31,Saturday,7,Jul
2021-07-31,2950.0,0.0,87110.58,2021-07-31,Saturday,7,Jul
2021-07-31,10.0,0.0,87100.58,2021-07-31,Saturday,7,Jul
2021-07-31,0.75,0.0,87099.83,2021-07-31,Saturday,7,Jul
2021-07-31,4500.0,0.0,82599.83,2021-07-31,Saturday,7,Jul
2021-07-31,10.0,0.0,82589.83,2021-07-31,Saturday,7,Jul
2021-07-31,0.75,0.0,82589.08,2021-07-31,Saturday,7,Jul
2021-07-31,80000.0,0.0,2589.08,2021-07-31,Saturday,7,Jul
2021-07-31,50.0,0.0,2539.08,2021-07-31,Saturday,7,Jul
2021-07-31,3.75,0.0,2535.33,2021-07-31,Saturday,7,Jul
2021-07-31,50.0,0.0,2485.33,2021-07-31,Saturday,7,Jul
2021-08-01,200.0,0.0,2285.33,2021-08-01,Sunday,8,Aug
2021-08-01,300.0,0.0,1985.33,2021-08-01,Sunday,8,Aug
2021-08-01,10.0,0.0,1975.33,2021-08-01,Sunday,8,Aug
2021-08-01,0.75,0.0,1974.58,2021-08-01,Sunday,8,Aug
2021-08-02,800.0,0.0,1174.58,2021-08-02,Monday,8,Aug
2021-08-02,100.0,0.0,1074.58,2021-08-02,Monday,8,Aug
2021-08-02,28.8,0.0,1045.78,2021-08-02,Monday,8,Aug
2021-08-03,800.0,0.0,245.78,2021-08-03,Tuesday,8,Aug
2021-08-03,10.0,0.0,235.78,2021-08-03,Tuesday,8,Aug
2021-08-03,0.75,0.0,235.03,2021-08-03,Tuesday,8,Aug
2021-08-04,0.0,53350.0,53585.03,2021-08-04,Wednesday,8,Aug
2021-08-04,53000.0,0.0,585.03,2021-08-04,Wednesday,8,Aug
2021-08-04,50.0,0.0,535.03,2021-08-04,Wednesday,8,Aug
2021-08-04,3.75,0.0,531.28,2021-08-04,Wednesday,8,Aug
2021-08-04,0.0,53597.35,54128.63,2021-08-04,Wednesday,8,Aug
2021-08-04,10000.0,0.0,44128.63,2021-08-04,Wednesday,8,Aug
2021-08-04,25.0,0.0,44103.63,2021-08-04,Wednesday,8,Aug
2021-08-04,1.87,0.0,44101.76,2021-08-04,Wednesday,8,Aug
2021-08-04,44000.0,0.0,101.76,2021-08-04,Wednesday,8,Aug
2021-08-04,25.0,0.0,76.76,2021-08-04,Wednesday,8,Aug
2021-08-04,1.87,0.0,74.89,2021-08-04,Wednesday,8,Aug
2021-08-04,0.0,55775.0,55849.89,2021-08-04,Wednesday,8,Aug
2021-08-04,55000.0,0.0,849.89,2021-08-04,Wednesday,8,Aug
2021-08-04,50.0,0.0,799.89,2021-08-04,Wednesday,8,Aug
2021-08-04,3.75,0.0,796.14,2021-08-04,Wednesday,8,Aug
2021-08-04,500.0,0.0,296.14,2021-08-04,Wednesday,8,Aug
2021-08-04,100.0,0.0,196.14,2021-08-04,Wednesday,8,Aug
2021-08-05,0.0,3395.0,3591.14,2021-08-05,Thursday,8,Aug
2021-08-05,1000.0,0.0,2591.14,2021-08-05,Thursday,8,Aug
2021-08-05,10.0,0.0,2581.14,2021-08-05,Thursday,8,Aug
2021-08-05,0.75,0.0,2580.39,2021-08-05,Thursday,8,Aug
2021-08-05,1350.0,0.0,1230.39,2021-08-05,Thursday,8,Aug
2021-08-05,10.0,0.0,1220.39,2021-08-05,Thursday,8,Aug
2021-08-05,0.75,0.0,1219.64,2021-08-05,Thursday,8,Aug
2021-08-06,100.0,0.0,1119.64,2021-08-06,Friday,8,Aug
2021-08-06,0.0,2240.7,3360.34,2021-08-06,Friday,8,Aug
2021-08-06,250.0,0.0,3110.34,2021-08-06,Friday,8,Aug
2021-08-06,2700.0,0.0,410.34,2021-08-06,Friday,8,Aug
2021-08-06,10.0,0.0,400.34,2021-08-06,Friday,8,Aug
2021-08-06,0.75,0.0,399.59,2021-08-06,Friday,8,Aug
2021-08-07,200.0,0.0,199.59,2021-08-07,Saturday,8,Aug
2021-08-07,100.0,0.0,99.59,2021-08-07,Saturday,8,Aug
2021-08-09,0.0,13182.3,13281.89,2021-08-09,Monday,8,Aug
2021-08-09,13000.0,0.0,281.89,2021-08-09,Monday,8,Aug
2021-08-09,25.0,0.0,256.89,2021-08-09,Monday,8,Aug
2021-08-09,1.87,0.0,255.02,2021-08-09,Monday,8,Aug
2021-08-10,200.0,0.0,55.02,2021-08-10,Tuesday,8,Aug
2021-08-10,0.0,4850.0,4905.02,2021-08-10,Tuesday,8,Aug
2021-08-10,200.0,0.0,4705.02,2021-08-10,Tuesday,8,Aug
2021-08-10,3000.0,0.0,1705.02,2021-08-10,Tuesday,8,Aug
2021-08-10,10.0,0.0,1695.02,2021-08-10,Tuesday,8,Aug
2021-08-10,0.75,0.0,1694.27,2021-08-10,Tuesday,8,Aug
2021-08-10,1500.0,0.0,194.27,2021-08-10,Tuesday,8,Aug
2021-08-10,10.0,0.0,184.27,2021-08-10,Tuesday,8,Aug
2021-08-10,0.75,0.0,183.52,2021-08-10,Tuesday,8,Aug
2021-08-11,0.0,9215.0,9398.52,2021-08-11,Wednesday,8,Aug
2021-08-12,5000.0,0.0,4398.52,2021-08-12,Thursday,8,Aug
2021-08-12,10.0,0.0,4388.52,2021-08-12,Thursday,8,Aug
2021-08-12,0.75,0.0,4387.77,2021-08-12,Thursday,8,Aug
2021-08-12,0.0,4850.0,9237.77,2021-08-12,Thursday,8,Aug
2021-08-12,5000.0,0.0,4237.77,2021-08-12,Thursday,8,Aug
2021-08-12,10.0,0.0,4227.77,2021-08-12,Thursday,8,Aug
2021-08-12,0.75,0.0,4227.02,2021-08-12,Thursday,8,Aug
2021-08-12,0.0,32504.7,36731.72,2021-08-12,Thursday,8,Aug
2021-08-12,30000.0,0.0,6731.72,2021-08-12,Thursday,8,Aug
2021-08-12,200.0,0.0,6531.72,2021-08-12,Thursday,8,Aug
2021-08-12,0.0,200000.0,206531.72,2021-08-12,Thursday,8,Aug
2021-08-12,0.0,73000.0,279531.72,2021-08-12,Thursday,8,Aug
2021-08-12,73000.0,0.0,206531.72,2021-08-12,Thursday,8,Aug
2021-08-12,200.0,0.0,206331.72,2021-08-12,Thursday,8,Aug
2021-08-12,3000.0,0.0,203331.72,2021-08-12,Thursday,8,Aug
2021-08-12,199000.0,0.0,4331.72,2021-08-12,Thursday,8,Aug
2021-08-12,50.0,0.0,4281.72,2021-08-12,Thursday,8,Aug
2021-08-12,3.75,0.0,4277.97,2021-08-12,Thursday,8,Aug
2021-08-12,100.0,0.0,4177.97,2021-08-12,Thursday,8,Aug
2021-08-12,100.0,0.0,4077.97,2021-08-12,Thursday,8,Aug
2021-08-13,4000.0,0.0,77.97,2021-08-13,Friday,8,Aug
2021-08-13,0.0,50000.0,50077.97,2021-08-13,Friday,8,Aug
2021-08-13,23000.0,0.0,27077.97,2021-08-13,Friday,8,Aug
2021-08-13,25.0,0.0,27052.97,2021-08-13,Friday,8,Aug
2021-08-13,1.87,0.0,27051.1,2021-08-13,Friday,8,Aug
2021-08-13,24000.0,0.0,3051.1,2021-08-13,Friday,8,Aug
2021-08-13,25.0,0.0,3026.1,2021-08-13,Friday,8,Aug
2021-08-13,1.87,0.0,3024.23,2021-08-13,Friday,8,Aug
2021-08-13,1000.0,0.0,2024.23,2021-08-13,Friday,8,Aug
2021-08-13,1000.0,0.0,1024.23,2021-08-13,Friday,8,Aug
2021-08-13,50.0,0.0,974.23,2021-08-13,Friday,8,Aug
2021-08-15,100.0,0.0,874.23,2021-08-15,Sunday,8,Aug
2021-08-15,0.0,1000.0,1874.23,2021-08-15,Sunday,8,Aug
2021-08-15,1000.0,0.0,874.23,2021-08-15,Sunday,8,Aug
2021-08-15,20.0,0.0,854.23,2021-08-15,Sunday,8,Aug
2021-08-15,1.5,0.0,852.73,2021-08-15,Sunday,8,Aug
2021-08-15,200.0,0.0,652.73,2021-08-15,Sunday,8,Aug
2021-08-15,200.0,0.0,452.73,2021-08-15,Sunday,8,Aug
2021-08-18,100.0,0.0,352.73,2021-08-18,Wednesday,8,Aug
2021-08-19,200.0,0.0,152.73,2021-08-19,Thursday,8,Aug
2021-08-21,0.0,21000.0,21152.73,2021-08-21,Saturday,8,Aug
2021-08-21,18400.0,0.0,2752.73,2021-08-21,Saturday,8,Aug
2021-08-21,1500.0,0.0,1252.73,2021-08-21,Saturday,8,Aug
2021-08-21,10.0,0.0,1242.73,2021-08-21,Saturday,8,Aug
2021-08-21,0.75,0.0,1241.98,2021-08-21,Saturday,8,Aug
2021-08-22,50.0,0.0,1191.98,2021-08-22,Sunday,8,Aug
2021-08-23,200.0,0.0,991.98,2021-08-23,Monday,8,Aug
2021-08-23,290.0,0.0,701.98,2021-08-23,Monday,8,Aug
2021-08-23,700.0,0.0,1.98,2021-08-23,Monday,8,Aug
2021-08-23,0.0,1050.0,1051.98,2021-08-23,Monday,8,Aug
2021-08-24,500.0,0.0,551.98,2021-08-24,Tuesday,8,Aug
2021-08-24,0.0,48500.0,49051.98,2021-08-24,Tuesday,8,Aug
2021-08-24,0.0,1139.75,50191.73,2021-08-24,Tuesday,8,Aug
2021-08-24,50000.0,0.0,191.73,2021-08-24,Tuesday,8,Aug
2021-08-24,25.0,0.0,166.73,2021-08-24,Tuesday,8,Aug
2021-08-24,1.87,0.0,164.86,2021-08-24,Tuesday,8,Aug
2021-08-24,100.0,0.0,64.86,2021-08-24,Tuesday,8,Aug
2021-08-30,0.0,5000.0,5064.86,2021-08-30,Monday,8,Aug
2021-08-30,5000.0,0.0,64.86,2021-08-30,Monday,8,Aug
2021-08-30,10.0,0.0,54.86,2021-08-30,Monday,8,Aug
2021-08-30,0.75,0.0,54.11,2021-08-30,Monday,8,Aug
2021-08-30,0.0,15000.0,15054.11,2021-08-30,Monday,8,Aug
2021-08-30,14000.0,0.0,1054.11,2021-08-30,Monday,8,Aug
2021-08-30,25.0,0.0,1029.11,2021-08-30,Monday,8,Aug
2021-08-30,1.87,0.0,1027.24,2021-08-30,Monday,8,Aug
2021-08-30,50.0,0.0,977.24,2021-08-30,Monday,8,Aug
2021-08-30,400.0,0.0,577.24,2021-08-30,Monday,8,Aug
2021-09-01,300.0,0.0,277.24,2021-09-01,Wednesday,9,Sep
2021-09-01,0.0,10000.0,10277.24,2021-09-01,Wednesday,9,Sep
2021-09-01,500.0,0.0,9777.24,2021-09-01,Wednesday,9,Sep
2021-09-01,0.0,3000.0,12777.24,2021-09-01,Wednesday,9,Sep
2021-09-01,50.0,0.0,12727.24,2021-09-01,Wednesday,9,Sep
2021-09-02,0.0,4880.0,17607.24,2021-09-02,Thursday,9,Sep
2021-09-02,0.0,2000.0,19607.24,2021-09-02,Thursday,9,Sep
2021-09-02,0.0,3000.0,22607.24,2021-09-02,Thursday,9,Sep
2021-09-02,10000.0,0.0,12607.24,2021-09-02,Thursday,9,Sep
2021-09-02,0.0,12000.0,24607.24,2021-09-02,Thursday,9,Sep
2021-09-02,12000.0,0.0,12607.24,2021-09-02,Thursday,9,Sep
2021-09-02,0.0,1200.0,13807.24,2021-09-02,Thursday,9,Sep
2021-09-02,0.0,25000.0,38807.24,2021-09-02,Thursday,9,Sep
2021-09-02,25000.0,0.0,13807.24,2021-09-02,Thursday,9,Sep
2021-09-02,100.0,0.0,13707.24,2021-09-02,Thursday,9,Sep
2021-09-03,200.0,0.0,13507.24,2021-09-03,Friday,9,Sep
2021-09-03,200.0,0.0,13307.24,2021-09-03,Friday,9,Sep
2021-09-03,0.0,200000.0,213307.24,2021-09-03,Friday,9,Sep
2021-09-03,40000.0,0.0,173307.24,2021-09-03,Friday,9,Sep
2021-09-03,25.0,0.0,173282.24,2021-09-03,Friday,9,Sep
2021-09-03,1.87,0.0,173280.37,2021-09-03,Friday,9,Sep
2021-09-03,2672.52,0.0,170607.85,2021-09-03,Friday,9,Sep
2021-09-03,130000.0,0.0,40607.85,2021-09-03,Friday,9,Sep
2021-09-03,50.0,0.0,40557.85,2021-09-03,Friday,9,Sep
2021-09-03,3.75,0.0,40554.1,2021-09-03,Friday,9,Sep
2021-09-03,9000.0,0.0,31554.1,2021-09-03,Friday,9,Sep
2021-09-03,5200.0,0.0,26354.1,2021-09-03,Friday,9,Sep
2021-09-03,25.0,0.0,26329.1,2021-09-03,Friday,9,Sep
2021-09-03,1.87,0.0,26327.23,2021-09-03,Friday,9,Sep
2021-09-03,1000.0,0.0,25327.23,2021-09-03,Friday,9,Sep
2021-09-03,10.0,0.0,25317.23,2021-09-03,Friday,9,Sep
2021-09-03,0.75,0.0,25316.48,2021-09-03,Friday,9,Sep
2021-09-03,20000.0,0.0,5316.48,2021-09-03,Friday,9,Sep
2021-09-03,25.0,0.0,5291.48,2021-09-03,Friday,9,Sep
2021-09-03,1.87,0.0,5289.61,2021-09-03,Friday,9,Sep
2021-09-03,50.0,0.0,5239.61,2021-09-03,Friday,9,Sep
2021-09-04,0.0,20000.0,25239.61,2021-09-04,Saturday,9,Sep
2021-09-04,500.0,0.0,24739.61,2021-09-04,Saturday,9,Sep
2021-09-04,6000.0,0.0,18739.61,2021-09-04,Saturday,9,Sep
2021-09-04,25.0,0.0,18714.61,2021-09-04,Saturday,9,Sep
2021-09-04,1.87,0.0,18712.74,2021-09-04,Saturday,9,Sep
2021-09-04,15000.0,0.0,3712.74,2021-09-04,Saturday,9,Sep
2021-09-04,50.0,0.0,3662.74,2021-09-04,Saturday,9,Sep
2021-09-04,30.0,0.0,3632.74,2021-09-04,Saturday,9,Sep
2021-09-05,0.0,200.0,3832.74,2021-09-05,Sunday,9,Sep
2021-09-05,1400.0,0.0,2432.74,2021-09-05,Sunday,9,Sep
2021-09-05,100.0,0.0,2332.74,2021-09-05,Sunday,9,Sep
2021-09-06,1500.0,0.0,832.74,2021-09-06,Monday,9,Sep
2021-09-07,0.0,55890.0,56722.74,2021-09-07,Tuesday,9,Sep
2021-09-08,800.0,0.0,55922.74,2021-09-08,Wednesday,9,Sep
2021-09-08,55000.0,0.0,922.74,2021-09-08,Wednesday,9,Sep
2021-09-08,50.0,0.0,872.74,2021-09-08,Wednesday,9,Sep
2021-09-08,3.75,0.0,868.99,2021-09-08,Wednesday,9,Sep
2021-09-08,300.0,0.0,568.99,2021-09-08,Wednesday,9,Sep
2021-09-08,200.0,0.0,368.99,2021-09-08,Wednesday,9,Sep
2021-09-10,0.0,500.0,868.99,2021-09-10,Friday,9,Sep
2021-09-10,450.0,0.0,418.99,2021-09-10,Friday,9,Sep
2021-09-11,400.0,0.0,18.99,2021-09-11,Saturday,9,Sep
2021-09-12,0.0,1000.0,1018.99,2021-09-12,Sunday,9,Sep
2021-09-13,0.0,4900.0,5918.99,2021-09-13,Monday,9,Sep
2021-09-13,5175.0,0.0,743.99,2021-09-13,Monday,9,Sep
2021-09-13,0.0,4900.0,5643.99,2021-09-13,Monday,9,Sep
2021-09-13,100.0,0.0,5543.99,2021-09-13,Monday,9,Sep
2021-09-13,1850.0,0.0,3693.99,2021-09-13,Monday,9,Sep
2021-09-13,500.0,0.0,3193.99,2021-09-13,Monday,9,Sep
2021-09-13,2000.0,0.0,1193.99,2021-09-13,Monday,9,Sep
2021-09-13,10.0,0.0,1183.99,2021-09-13,Monday,9,Sep
2021-09-13,0.75,0.0,1183.24,2021-09-13,Monday,9,Sep
2021-09-15,450.0,0.0,733.24,2021-09-15,Wednesday,9,Sep
2021-09-16,200.0,0.0,533.24,2021-09-16,Thursday,9,Sep
2021-09-17,300.0,0.0,233.24,2021-09-17,Friday,9,Sep
2021-09-18,200.0,0.0,33.24,2021-09-18,Saturday,9,Sep
2021-09-18,0.0,7000.0,7033.24,2021-09-18,Saturday,9,Sep
2021-09-18,0.0,40050.0,47083.24,2021-09-18,Saturday,9,Sep
2021-09-18,47000.0,0.0,83.24,2021-09-18,Saturday,9,Sep
2021-09-18,25.0,0.0,58.24,2021-09-18,Saturday,9,Sep
2021-09-18,1.87,0.0,56.37,2021-09-18,Saturday,9,Sep
2021-09-21,0.0,10000.0,10056.37,2021-09-21,Tuesday,9,Sep
2021-09-21,200.0,0.0,9856.37,2021-09-21,Tuesday,9,Sep
2021-09-21,300.0,0.0,9556.37,2021-09-21,Tuesday,9,Sep
2021-09-21,0.0,7350.0,16906.37,2021-09-21,Tuesday,9,Sep
2021-09-21,3000.0,0.0,13906.37,2021-09-21,Tuesday,9,Sep
2021-09-21,4300.0,0.0,9606.37,2021-09-21,Tuesday,9,Sep
2021-09-21,0.0,2000.0,11606.37,2021-09-21,Tuesday,9,Sep
2021-09-21,50.0,0.0,11556.37,2021-09-21,Tuesday,9,Sep
2021-09-22,200.0,0.0,11356.37,2021-09-22,Wednesday,9,Sep
2021-09-22,200.0,0.0,11156.37,2021-09-22,Wednesday,9,Sep
2021-09-23,9500.0,0.0,1656.37,2021-09-23,Thursday,9,Sep
2021-09-23,200.0,0.0,1456.37,2021-09-23,Thursday,9,Sep
2021-09-23,200.0,0.0,1256.37,2021-09-23,Thursday,9,Sep
2021-09-24,200.0,0.0,1056.37,2021-09-24,Friday,9,Sep
2021-09-24,200.0,0.0,856.37,2021-09-24,Friday,9,Sep
2021-09-25,200.0,0.0,656.37,2021-09-25,Saturday,9,Sep
2021-09-25,0.0,500000.0,500656.37,2021-09-25,Saturday,9,Sep
2021-09-25,400000.0,0.0,100656.37,2021-09-25,Saturday,9,Sep
2021-09-25,200.0,0.0,100456.37,2021-09-25,Saturday,9,Sep
2021-09-25,50.0,0.0,100406.37,2021-09-25,Saturday,9,Sep
2021-09-26,20000.0,0.0,80406.37,2021-09-26,Sunday,9,Sep
2021-09-26,25.0,0.0,80381.37,2021-09-26,Sunday,9,Sep
2021-09-26,1.87,0.0,80379.5,2021-09-26,Sunday,9,Sep
2021-09-26,80000.0,0.0,379.5,2021-09-26,Sunday,9,Sep
2021-09-26,50.0,0.0,329.5,2021-09-26,Sunday,9,Sep
2021-09-26,3.75,0.0,325.75,2021-09-26,Sunday,9,Sep
2021-09-26,0.0,15000.0,15325.75,2021-09-26,Sunday,9,Sep
2021-09-26,50.0,0.0,15275.75,2021-09-26,Sunday,9,Sep
2021-09-26,23.1,0.0,15252.65,2021-09-26,Sunday,9,Sep
2021-09-27,200.0,0.0,15052.65,2021-09-27,Monday,9,Sep
2021-09-27,14444.0,0.0,608.65,2021-09-27,Monday,9,Sep
2021-09-27,200.0,0.0,408.65,2021-09-27,Monday,9,Sep
2021-09-28,308.0,0.0,100.65,2021-09-28,Tuesday,9,Sep
2021-09-28,100.0,0.0,0.65,2021-09-28,Tuesday,9,Sep
2021-09-28,0.0,6000.0,6000.65,2021-09-28,Tuesday,9,Sep
2021-09-28,5000.0,0.0,1000.65,2021-09-28,Tuesday,9,Sep
2021-09-28,20.0,0.0,980.65,2021-09-28,Tuesday,9,Sep
2021-09-28,1.5,0.0,979.15,2021-09-28,Tuesday,9,Sep
2021-09-28,300.0,0.0,679.15,2021-09-28,Tuesday,9,Sep
2021-09-29,200.0,0.0,479.15,2021-09-29,Wednesday,9,Sep
2021-09-30,400.0,0.0,79.15,2021-09-30,Thursday,9,Sep
2021-10-01,0.0,213120.0,213199.15,2021-10-01,Friday,10,Oct
2021-10-01,50000.0,0.0,163199.15,2021-10-01,Friday,10,Oct
2021-10-01,25.0,0.0,163174.15,2021-10-01,Friday,10,Oct
2021-10-01,1.87,0.0,163172.28,2021-10-01,Friday,10,Oct
2021-10-01,100000.0,0.0,63172.28,2021-10-01,Friday,10,Oct
2021-10-01,50.0,0.0,63122.28,2021-10-01,Friday,10,Oct
2021-10-01,3.75,0.0,63118.53,2021-10-01,Friday,10,Oct
2021-10-01,18000.0,0.0,45118.53,2021-10-01,Friday,10,Oct
2021-10-01,25.0,0.0,45093.53,2021-10-01,Friday,10,Oct
2021-10-01,1.87,0.0,45091.66,2021-10-01,Friday,10,Oct
2021-10-01,17000.0,0.0,28091.66,2021-10-01,Friday,10,Oct
2021-10-01,25.0,0.0,28066.66,2021-10-01,Friday,10,Oct
2021-10-01,1.87,0.0,28064.79,2021-10-01,Friday,10,Oct
2021-10-01,5000.0,0.0,23064.79,2021-10-01,Friday,10,Oct
2021-10-01,10.0,0.0,23054.79,2021-10-01,Friday,10,Oct
2021-10-01,0.75,0.0,23054.04,2021-10-01,Friday,10,Oct
2021-10-01,10000.0,0.0,13054.04,2021-10-01,Friday,10,Oct
2021-10-01,25.0,0.0,13029.04,2021-10-01,Friday,10,Oct
2021-10-01,1.87,0.0,13027.17,2021-10-01,Friday,10,Oct
2021-10-01,1000.0,0.0,12027.17,2021-10-01,Friday,10,Oct
2021-10-01,10.0,0.0,12017.17,2021-10-01,Friday,10,Oct
2021-10-01,0.75,0.0,12016.42,2021-10-01,Friday,10,Oct
2021-10-01,1500.0,0.0,10516.42,2021-10-01,Friday,10,Oct
2021-10-01,5000.0,0.0,5516.42,2021-10-01,Friday,10,Oct
2021-10-01,10.0,0.0,5506.42,2021-10-01,Friday,10,Oct
2021-10-01,0.75,0.0,5505.67,2021-10-01,Friday,10,Oct
2021-10-01,300.0,0.0,5205.67,2021-10-01,Friday,10,Oct
2021-10-01,50.0,0.0,5155.67,2021-10-01,Friday,10,Oct
2021-10-02,4100.0,0.0,1055.67,2021-10-02,Saturday,10,Oct
2021-10-02,10.0,0.0,1045.67,2021-10-02,Saturday,10,Oct
2021-10-02,0.75,0.0,1044.92,2021-10-02,Saturday,10,Oct
2021-10-02,100.0,0.0,944.92,2021-10-02,Saturday,10,Oct
2021-10-02,0.0,1000.0,1944.92,2021-10-02,Saturday,10,Oct
2021-10-02,0.0,92000.0,93944.92,2021-10-02,Saturday,10,Oct
2021-10-02,10001.7,0.0,83943.22,2021-10-02,Saturday,10,Oct
2021-10-02,25.0,0.0,83918.22,2021-10-02,Saturday,10,Oct
2021-10-02,1.87,0.0,83916.35,2021-10-02,Saturday,10,Oct
2021-10-02,300.0,0.0,83616.35,2021-10-02,Saturday,10,Oct
2021-10-02,20499.18,0.0,63117.17,2021-10-02,Saturday,10,Oct
2021-10-02,25.0,0.0,63092.17,2021-10-02,Saturday,10,Oct
2021-10-02,1.87,0.0,63090.3,2021-10-02,Saturday,10,Oct
2021-10-02,200.0,0.0,62890.3,2021-10-02,Saturday,10,Oct
2021-10-02,300.0,0.0,62590.3,2021-10-02,Saturday,10,Oct
2021-10-02,3000.0,0.0,59590.3,2021-10-02,Saturday,10,Oct
2021-10-02,10.0,0.0,59580.3,2021-10-02,Saturday,10,Oct
2021-10-02,0.75,0.0,59579.55,2021-10-02,Saturday,10,Oct
2021-10-02,50.0,0.0,59529.55,2021-10-02,Saturday,10,Oct
2021-10-03,6900.0,0.0,52629.55,2021-10-03,Sunday,10,Oct
2021-10-03,25.0,0.0,52604.55,2021-10-03,Sunday,10,Oct
2021-10-03,1.87,0.0,52602.68,2021-10-03,Sunday,10,Oct
2021-10-03,7000.0,0.0,45602.68,2021-10-03,Sunday,10,Oct
2021-10-03,300.0,0.0,45302.68,2021-10-03,Sunday,10,Oct
2021-10-04,900.0,0.0,44402.68,2021-10-04,Monday,10,Oct
2021-10-04,2000.0,0.0,42402.68,2021-10-04,Monday,10,Oct
2021-10-04,10.0,0.0,42392.68,2021-10-04,Monday,10,Oct
2021-10-04,0.75,0.0,42391.93,2021-10-04,Monday,10,Oct
2021-10-04,5100.0,0.0,37291.93,2021-10-04,Monday,10,Oct
2021-10-04,25.0,0.0,37266.93,2021-10-04,Monday,10,Oct
2021-10-04,1.87,0.0,37265.06,2021-10-04,Monday,10,Oct
2021-10-04,200.0,0.0,37065.06,2021-10-04,Monday,10,Oct
2021-10-04,450.0,0.0,36615.06,2021-10-04,Monday,10,Oct
2021-10-04,300.0,0.0,36315.06,2021-10-04,Monday,10,Oct
2021-10-04,5000.0,0.0,31315.06,2021-10-04,Monday,10,Oct
2021-10-05,2500.0,0.0,28815.06,2021-10-05,Tuesday,10,Oct
2021-10-05,200.0,0.0,28615.06,2021-10-05,Tuesday,10,Oct
2021-10-05,15000.0,0.0,13615.06,2021-10-05,Tuesday,10,Oct
2021-10-05,25.0,0.0,13590.06,2021-10-05,Tuesday,10,Oct
2021-10-05,1.87,0.0,13588.19,2021-10-05,Tuesday,10,Oct
2021-10-06,3100.0,0.0,10488.19,2021-10-06,Wednesday,10,Oct
2021-10-06,10.0,0.0,10478.19,2021-10-06,Wednesday,10,Oct
2021-10-06,0.75,0.0,10477.44,2021-10-06,Wednesday,10,Oct
2021-10-06,5000.0,0.0,5477.44,2021-10-06,Wednesday,10,Oct
2021-10-06,10.0,0.0,5467.44,2021-10-06,Wednesday,10,Oct
2021-10-06,0.75,0.0,5466.69,2021-10-06,Wednesday,10,Oct
2021-10-06,200.0,0.0,5266.69,2021-10-06,Wednesday,10,Oct
2021-10-06,10.0,0.0,5256.69,2021-10-06,Wednesday,10,Oct
2021-10-06,0.75,0.0,5255.94,2021-10-06,Wednesday,10,Oct
2021-10-06,5100.0,0.0,155.94,2021-10-06,Wednesday,10,Oct
2021-10-07,100.0,0.0,55.94,2021-10-07,Thursday,10,Oct
2021-10-07,0.0,20000.0,20055.94,2021-10-07,Thursday,10,Oct
2021-10-07,3100.0,0.0,16955.94,2021-10-07,Thursday,10,Oct
2021-10-07,500.0,0.0,16455.94,2021-10-07,Thursday,10,Oct
2021-10-07,50.0,0.0,16405.94,2021-10-07,Thursday,10,Oct
2021-10-08,200.0,0.0,16205.94,2021-10-08,Friday,10,Oct
2021-10-08,0.0,32000.0,48205.94,2021-10-08,Friday,10,Oct
2021-10-08,3500.0,0.0,44705.94,2021-10-08,Friday,10,Oct
2021-10-08,10.0,0.0,44695.94,2021-10-08,Friday,10,Oct
2021-10-08,0.75,0.0,44695.19,2021-10-08,Friday,10,Oct
2021-10-08,0.0,9990.0,54685.19,2021-10-08,Friday,10,Oct
2021-10-08,10000.0,0.0,44685.19,2021-10-08,Friday,10,Oct
2021-10-08,300.0,0.0,44385.19,2021-10-08,Friday,10,Oct
2021-10-08,0.0,10000.0,54385.19,2021-10-08,Friday,10,Oct
2021-10-08,0.0,10000.0,64385.19,2021-10-08,Friday,10,Oct
2021-10-08,20000.01,0.0,44385.18,2021-10-08,Friday,10,Oct
2021-10-08,25.0,0.0,44360.18,2021-10-08,Friday,10,Oct
2021-10-08,1.87,0.0,44358.31,2021-10-08,Friday,10,Oct
2021-10-08,0.0,30000.0,74358.31,2021-10-08,Friday,10,Oct
2021-10-08,30000.0,0.0,44358.31,2021-10-08,Friday,10,Oct
2021-10-08,25.0,0.0,44333.31,2021-10-08,Friday,10,Oct
2021-10-08,1.87,0.0,44331.44,2021-10-08,Friday,10,Oct
2021-10-08,200.0,0.0,44131.44,2021-10-08,Friday,10,Oct
2021-10-09,10000.0,0.0,34131.44,2021-10-09,Saturday,10,Oct
2021-10-09,0.0,208150.0,242281.44,2021-10-09,Saturday,10,Oct
2021-10-09,10000.0,0.0,232281.44,2021-10-09,Saturday,10,Oct
2021-10-09,25.0,0.0,232256.44,2021-10-09,Saturday,10,Oct
2021-10-09,1.87,0.0,232254.57,2021-10-09,Saturday,10,Oct
2021-10-09,30000.0,0.0,202254.57,2021-10-09,Saturday,10,Oct
2021-10-09,10000.0,0.0,192254.57,2021-10-09,Saturday,10,Oct
2021-10-09,150000.0,0.0,42254.57,2021-10-09,Saturday,10,Oct
2021-10-09,50.0,0.0,42204.57,2021-10-09,Saturday,10,Oct
2021-10-09,3.75,0.0,42200.82,2021-10-09,Saturday,10,Oct
2021-10-09,1100.0,0.0,41100.82,2021-10-09,Saturday,10,Oct
2021-10-09,10.0,0.0,41090.82,2021-10-09,Saturday,10,Oct
2021-10-09,0.75,0.0,41090.07,2021-10-09,Saturday,10,Oct
2021-10-09,600.0,0.0,40490.07,2021-10-09,Saturday,10,Oct
2021-10-09,10.0,0.0,40480.07,2021-10-09,Saturday,10,Oct
2021-10-09,0.75,0.0,40479.32,2021-10-09,Saturday,10,Oct
2021-10-09,2000.0,0.0,38479.32,2021-10-09,Saturday,10,Oct
2021-10-09,0.0,10000.0,48479.32,2021-10-09,Saturday,10,Oct
2021-10-09,5300.0,0.0,43179.32,2021-10-09,Saturday,10,Oct
2021-10-09,25.0,0.0,43154.32,2021-10-09,Saturday,10,Oct
2021-10-09,1.87,0.0,43152.45,2021-10-09,Saturday,10,Oct
2021-10-09,100.0,0.0,43052.45,2021-10-09,Saturday,10,Oct
2021-10-10,300.0,0.0,42752.45,2021-10-10,Sunday,10,Oct
2021-10-10,4000.0,0.0,38752.45,2021-10-10,Sunday,10,Oct
2021-10-10,10.0,0.0,38742.45,2021-10-10,Sunday,10,Oct
2021-10-10,0.75,0.0,38741.7,2021-10-10,Sunday,10,Oct
2021-10-10,3100.0,0.0,35641.7,2021-10-10,Sunday,10,Oct
2021-10-10,10.0,0.0,35631.7,2021-10-10,Sunday,10,Oct
2021-10-10,0.75,0.0,35630.95,2021-10-10,Sunday,10,Oct
2021-10-10,700.0,0.0,34930.95,2021-10-10,Sunday,10,Oct
2021-10-10,10.0,0.0,34920.95,2021-10-10,Sunday,10,Oct
2021-10-10,0.75,0.0,34920.2,2021-10-10,Sunday,10,Oct
2021-10-10,2000.0,0.0,32920.2,2021-10-10,Sunday,10,Oct
2021-10-10,10.0,0.0,32910.2,2021-10-10,Sunday,10,Oct
2021-10-10,0.75,0.0,32909.45,2021-10-10,Sunday,10,Oct
2021-10-10,1400.0,0.0,31509.45,2021-10-10,Sunday,10,Oct
2021-10-10,10.0,0.0,31499.45,2021-10-10,Sunday,10,Oct
2021-10-10,0.75,0.0,31498.7,2021-10-10,Sunday,10,Oct
2021-10-10,400.0,0.0,31098.7,2021-10-10,Sunday,10,Oct
2021-10-10,0.0,10000.0,41098.7,2021-10-10,Sunday,10,Oct
2021-10-11,3500.0,0.0,37598.7,2021-10-11,Monday,10,Oct
2021-10-11,10.0,0.0,37588.7,2021-10-11,Monday,10,Oct
2021-10-11,0.75,0.0,37587.95,2021-10-11,Monday,10,Oct
2021-10-11,31059.0,0.0,6528.95,2021-10-11,Monday,10,Oct
2021-10-11,200.0,0.0,6328.95,2021-10-11,Monday,10,Oct
2021-10-11,0.0,10000.0,16328.95,2021-10-11,Monday,10,Oct
2021-10-11,300.0,0.0,16028.95,2021-10-11,Monday,10,Oct
2021-10-11,2100.0,0.0,13928.95,2021-10-11,Monday,10,Oct
2021-10-11,50.0,0.0,13878.95,2021-10-11,Monday,10,Oct
2021-10-12,800.0,0.0,13078.95,2021-10-12,Tuesday,10,Oct
2021-10-12,10.1,0.0,13068.85,2021-10-12,Tuesday,10,Oct
2021-10-12,10.0,0.0,13058.85,2021-10-12,Tuesday,10,Oct
2021-10-12,0.75,0.0,13058.1,2021-10-12,Tuesday,10,Oct
2021-10-12,200.0,0.0,12858.1,2021-10-12,Tuesday,10,Oct
2021-10-13,10000.0,0.0,2858.1,2021-10-13,Wednesday,10,Oct
2021-10-13,2300.0,0.0,558.1,2021-10-13,Wednesday,10,Oct
2021-10-13,100.0,0.0,458.1,2021-10-13,Wednesday,10,Oct
2021-10-13,200.0,0.0,258.1,2021-10-13,Wednesday,10,Oct
2021-10-13,100.0,0.0,158.1,2021-10-13,Wednesday,10,Oct
2021-10-14,100.0,0.0,58.1,2021-10-14,Thursday,10,Oct
2021-10-14,50.0,0.0,8.1,2021-10-14,Thursday,10,Oct
2021-10-15,0.0,38556.0,38564.1,2021-10-15,Friday,10,Oct
2021-10-15,15000.0,0.0,23564.1,2021-10-15,Friday,10,Oct
2021-10-15,25.0,0.0,23539.1,2021-10-15,Friday,10,Oct
2021-10-15,1.87,0.0,23537.23,2021-10-15,Friday,10,Oct
2021-10-15,10000.0,0.0,13537.23,2021-10-15,Friday,10,Oct
2021-10-15,5000.0,0.0,8537.23,2021-10-15,Friday,10,Oct
2021-10-15,10.0,0.0,8527.23,2021-10-15,Friday,10,Oct
2021-10-15,0.75,0.0,8526.48,2021-10-15,Friday,10,Oct
2021-10-15,5000.0,0.0,3526.48,2021-10-15,Friday,10,Oct
2021-10-15,200.0,0.0,3326.48,2021-10-15,Friday,10,Oct
2021-10-15,200.0,0.0,3126.48,2021-10-15,Friday,10,Oct
2021-10-15,0.0,449820.0,452946.48,2021-10-15,Friday,10,Oct
2021-10-15,400000.0,0.0,52946.48,2021-10-15,Friday,10,Oct
2021-10-15,50.0,0.0,52896.48,2021-10-15,Friday,10,Oct
2021-10-15,3.75,0.0,52892.73,2021-10-15,Friday,10,Oct
2021-10-15,10000.0,0.0,42892.73,2021-10-15,Friday,10,Oct
2021-10-15,1700.0,0.0,41192.73,2021-10-15,Friday,10,Oct
2021-10-15,10.0,0.0,41182.73,2021-10-15,Friday,10,Oct
2021-10-15,0.75,0.0,41181.98,2021-10-15,Friday,10,Oct
2021-10-16,100.0,0.0,41081.98,2021-10-16,Saturday,10,Oct
2021-10-16,500.0,0.0,40581.98,2021-10-16,Saturday,10,Oct
2021-10-16,200.0,0.0,40381.98,2021-10-16,Saturday,10,Oct
2021-10-16,1600.0,0.0,38781.98,2021-10-16,Saturday,10,Oct
2021-10-16,4001.0,0.0,34780.98,2021-10-16,Saturday,10,Oct
2021-10-16,10.0,0.0,34770.98,2021-10-16,Saturday,10,Oct
2021-10-16,0.75,0.0,34770.23,2021-10-16,Saturday,10,Oct
2021-10-16,1000.0,0.0,33770.23,2021-10-16,Saturday,10,Oct
2021-10-16,300.0,0.0,33470.23,2021-10-16,Saturday,10,Oct
2021-10-17,200.0,0.0,33270.23,2021-10-17,Sunday,10,Oct
2021-10-17,0.0,31500.0,64770.23,2021-10-17,Sunday,10,Oct
2021-10-17,31500.0,0.0,33270.23,2021-10-17,Sunday,10,Oct
2021-10-17,25.0,0.0,33245.23,2021-10-17,Sunday,10,Oct
2021-10-17,1.87,0.0,33243.36,2021-10-17,Sunday,10,Oct
2021-10-17,30000.0,0.0,3243.36,2021-10-17,Sunday,10,Oct
2021-10-17,0.0,20000.0,23243.36,2021-10-17,Sunday,10,Oct
2021-10-17,20000.0,0.0,3243.36,2021-10-17,Sunday,10,Oct
2021-10-17,1000.0,0.0,2243.36,2021-10-17,Sunday,10,Oct
2021-10-17,0.0,50000.0,52243.36,2021-10-17,Sunday,10,Oct
2021-10-17,50000.0,0.0,2243.36,2021-10-17,Sunday,10,Oct
2021-10-17,150.0,0.0,2093.36,2021-10-17,Sunday,10,Oct
2021-10-18,200.0,0.0,1893.36,2021-10-18,Monday,10,Oct
2021-10-18,200.0,0.0,1693.36,2021-10-18,Monday,10,Oct
2021-10-18,50.0,0.0,1643.36,2021-10-18,Monday,10,Oct
2021-10-19,800.0,0.0,843.36,2021-10-19,Tuesday,10,Oct
2021-10-19,800.0,0.0,43.36,2021-10-19,Tuesday,10,Oct
2021-10-21,0.0,217950.0,217993.36,2021-10-21,Thursday,10,Oct
2021-10-21,200000.0,0.0,17993.36,2021-10-21,Thursday,10,Oct
2021-10-21,50.0,0.0,17943.36,2021-10-21,Thursday,10,Oct
2021-10-21,3.75,0.0,17939.61,2021-10-21,Thursday,10,Oct
2021-10-22,50.0,0.0,17889.61,2021-10-22,Friday,10,Oct
2021-10-22,5100.0,0.0,12789.61,2021-10-22,Friday,10,Oct
2021-10-22,400.0,0.0,12389.61,2021-10-22,Friday,10,Oct
2021-10-22,200.0,0.0,12189.61,2021-10-22,Friday,10,Oct
2021-10-22,200.0,0.0,11989.61,2021-10-22,Friday,10,Oct
2021-10-23,1600.0,0.0,10389.61,2021-10-23,Saturday,10,Oct
2021-10-23,10.0,0.0,10379.61,2021-10-23,Saturday,10,Oct
2021-10-23,0.75,0.0,10378.86,2021-10-23,Saturday,10,Oct
2021-10-23,200.0,0.0,10178.86,2021-10-23,Saturday,10,Oct
2021-10-23,1000.0,0.0,9178.86,2021-10-23,Saturday,10,Oct
2021-10-23,20.0,0.0,9158.86,2021-10-23,Saturday,10,Oct
2021-10-23,1.5,0.0,9157.36,2021-10-23,Saturday,10,Oct
2021-10-23,0.0,27000.0,36157.36,2021-10-23,Saturday,10,Oct
2021-10-23,28397.57,0.0,7759.79,2021-10-23,Saturday,10,Oct
2021-10-23,200.0,0.0,7559.79,2021-10-23,Saturday,10,Oct
2021-10-23,50.0,0.0,7509.79,2021-10-23,Saturday,10,Oct
2021-10-24,200.0,0.0,7309.79,2021-10-24,Sunday,10,Oct
2021-10-24,200.0,0.0,7109.79,2021-10-24,Sunday,10,Oct
2021-10-24,45.3,0.0,7064.49,2021-10-24,Sunday,10,Oct
2021-10-25,600.0,0.0,6464.49,2021-10-25,Monday,10,Oct
2021-10-25,45.3,0.0,6419.19,2021-10-25,Monday,10,Oct
2021-10-26,500.0,0.0,5919.19,2021-10-26,Tuesday,10,Oct
2021-10-26,200.0,0.0,5719.19,2021-10-26,Tuesday,10,Oct
2021-10-27,200.0,0.0,5519.19,2021-10-27,Wednesday,10,Oct
2021-10-27,0.0,45.3,5564.49,2021-10-27,Wednesday,10,Oct
2021-10-27,5500.0,0.0,64.49,2021-10-27,Wednesday,10,Oct
2021-10-29,0.0,83616.0,83680.49,2021-10-29,Friday,10,Oct
2021-10-29,2000.0,0.0,81680.49,2021-10-29,Friday,10,Oct
2021-10-29,20.0,0.0,81660.49,2021-10-29,Friday,10,Oct
2021-10-29,1.5,0.0,81658.99,2021-10-29,Friday,10,Oct
2021-10-29,5200.0,0.0,76458.99,2021-10-29,Friday,10,Oct
2021-10-29,25.0,0.0,76433.99,2021-10-29,Friday,10,Oct
2021-10-29,1.87,0.0,76432.12,2021-10-29,Friday,10,Oct
2021-10-29,50.0,0.0,76382.12,2021-10-29,Friday,10,Oct
2021-10-29,604.0,0.0,75778.12,2021-10-29,Friday,10,Oct
2021-10-30,70000.0,0.0,5778.12,2021-10-30,Saturday,10,Oct
2021-10-30,50.0,0.0,5728.12,2021-10-30,Saturday,10,Oct
2021-10-30,3.75,0.0,5724.37,2021-10-30,Saturday,10,Oct
2021-10-30,500.0,0.0,5224.37,2021-10-30,Saturday,10,Oct
2021-10-30,5000.0,0.0,224.37,2021-10-30,Saturday,10,Oct
2021-10-30,20.0,0.0,204.37,2021-10-30,Saturday,10,Oct
2021-10-30,1.5,0.0,202.87,2021-10-30,Saturday,10,Oct
2021-10-30,100.0,0.0,102.87,2021-10-30,Saturday,10,Oct
2021-11-02,0.0,20000.0,20102.87,2021-11-02,Tuesday,11,Nov
2021-11-02,0.0,1500.0,21602.87,2021-11-02,Tuesday,11,Nov
2021-11-02,200.0,0.0,21402.87,2021-11-02,Tuesday,11,Nov
2021-11-02,0.0,25000.0,46402.87,2021-11-02,Tuesday,11,Nov
2021-11-02,700.0,0.0,45702.87,2021-11-02,Tuesday,11,Nov
2021-11-02,10.0,0.0,45692.87,2021-11-02,Tuesday,11,Nov
2021-11-02,0.75,0.0,45692.12,2021-11-02,Tuesday,11,Nov
2021-11-02,100.0,0.0,45592.12,2021-11-02,Tuesday,11,Nov
2021-11-03,200.0,0.0,45392.12,2021-11-03,Wednesday,11,Nov
2021-11-03,200.0,0.0,45192.12,2021-11-03,Wednesday,11,Nov
2021-11-03,10.0,0.0,45182.12,2021-11-03,Wednesday,11,Nov
2021-11-03,0.75,0.0,45181.37,2021-11-03,Wednesday,11,Nov
2021-11-03,5000.0,0.0,40181.37,2021-11-03,Wednesday,11,Nov
2021-11-03,10.0,0.0,40171.37,2021-11-03,Wednesday,11,Nov
2021-11-03,0.75,0.0,40170.62,2021-11-03,Wednesday,11,Nov
2021-11-03,200.0,0.0,39970.62,2021-11-03,Wednesday,11,Nov
2021-11-03,200.0,0.0,39770.62,2021-11-03,Wednesday,11,Nov
2021-11-03,700.0,0.0,39070.62,2021-11-03,Wednesday,11,Nov
2021-11-03,10.0,0.0,39060.62,2021-11-03,Wednesday,11,Nov
2021-11-03,0.75,0.0,39059.87,2021-11-03,Wednesday,11,Nov
2021-11-04,9600.0,0.0,29459.87,2021-11-04,Thursday,11,Nov
2021-11-04,500.0,0.0,28959.87,2021-11-04,Thursday,11,Nov
2021-11-04,200.0,0.0,28759.87,2021-11-04,Thursday,11,Nov
2021-11-04,10000.0,0.0,18759.87,2021-11-04,Thursday,11,Nov
2021-11-04,3000.0,0.0,15759.87,2021-11-04,Thursday,11,Nov
2021-11-04,10.0,0.0,15749.87,2021-11-04,Thursday,11,Nov
2021-11-04,0.75,0.0,15749.12,2021-11-04,Thursday,11,Nov
2021-11-04,10000.0,0.0,5749.12,2021-11-04,Thursday,11,Nov
2021-11-04,900.0,0.0,4849.12,2021-11-04,Thursday,11,Nov
2021-11-05,0.0,425286.0,430135.12,2021-11-05,Friday,11,Nov
2021-11-05,2000.0,0.0,428135.12,2021-11-05,Friday,11,Nov
2021-11-05,10.0,0.0,428125.12,2021-11-05,Friday,11,Nov
2021-11-05,0.75,0.0,428124.37,2021-11-05,Friday,11,Nov
2021-11-05,15000.0,0.0,413124.37,2021-11-05,Friday,11,Nov
2021-11-05,25.0,0.0,413099.37,2021-11-05,Friday,11,Nov
2021-11-05,1.87,0.0,413097.5,2021-11-05,Friday,11,Nov
2021-11-05,2000.0,0.0,411097.5,2021-11-05,Friday,11,Nov
2021-11-05,400000.0,0.0,11097.5,2021-11-05,Friday,11,Nov
2021-11-05,50.0,0.0,11047.5,2021-11-05,Friday,11,Nov
2021-11-05,3.75,0.0,11043.75,2021-11-05,Friday,11,Nov
2021-11-05,2000.0,0.0,9043.75,2021-11-05,Friday,11,Nov
2021-11-05,10.0,0.0,9033.75,2021-11-05,Friday,11,Nov
2021-11-05,0.75,0.0,9033.0,2021-11-05,Friday,11,Nov
2021-11-05,50.0,0.0,8983.0,2021-11-05,Friday,11,Nov
2021-11-06,200.0,0.0,8783.0,2021-11-06,Saturday,11,Nov
2021-11-06,2200.0,0.0,6583.0,2021-11-06,Saturday,11,Nov
2021-11-06,10.0,0.0,6573.0,2021-11-06,Saturday,11,Nov
2021-11-06,0.75,0.0,6572.25,2021-11-06,Saturday,11,Nov
2021-11-07,0.0,100000.0,106572.25,2021-11-07,Sunday,11,Nov
2021-11-07,2000.0,0.0,104572.25,2021-11-07,Sunday,11,Nov
2021-11-07,10.0,0.0,104562.25,2021-11-07,Sunday,11,Nov
2021-11-07,0.75,0.0,104561.5,2021-11-07,Sunday,11,Nov
2021-11-07,60000.0,0.0,44561.5,2021-11-07,Sunday,11,Nov
2021-11-07,50.0,0.0,44511.5,2021-11-07,Sunday,11,Nov
2021-11-07,3.75,0.0,44507.75,2021-11-07,Sunday,11,Nov
2021-11-07,4000.0,0.0,40507.75,2021-11-07,Sunday,11,Nov
2021-11-07,10.0,0.0,40497.75,2021-11-07,Sunday,11,Nov
2021-11-07,0.75,0.0,40497.0,2021-11-07,Sunday,11,Nov
2021-11-07,2000.0,0.0,38497.0,2021-11-07,Sunday,11,Nov
2021-11-07,10.0,0.0,38487.0,2021-11-07,Sunday,11,Nov
2021-11-07,0.75,0.0,38486.25,2021-11-07,Sunday,11,Nov
2021-11-07,50.0,0.0,38436.25,2021-11-07,Sunday,11,Nov
2021-11-08,5000.0,0.0,33436.25,2021-11-08,Monday,11,Nov
2021-11-08,10.0,0.0,33426.25,2021-11-08,Monday,11,Nov
2021-11-08,0.75,0.0,33425.5,2021-11-08,Monday,11,Nov
2021-11-08,9999.0,0.0,23426.5,2021-11-08,Monday,11,Nov
2021-11-08,25.0,0.0,23401.5,2021-11-08,Monday,11,Nov
2021-11-08,1.87,0.0,23399.63,2021-11-08,Monday,11,Nov
2021-11-08,1217.04,0.0,22182.59,2021-11-08,Monday,11,Nov
2021-11-08,2000.0,0.0,20182.59,2021-11-08,Monday,11,Nov
2021-11-08,10.0,0.0,20172.59,2021-11-08,Monday,11,Nov
2021-11-08,0.75,0.0,20171.84,2021-11-08,Monday,11,Nov
2021-11-08,2000.0,0.0,18171.84,2021-11-08,Monday,11,Nov
2021-11-08,10.0,0.0,18161.84,2021-11-08,Monday,11,Nov
2021-11-08,0.75,0.0,18161.09,2021-11-08,Monday,11,Nov
2021-11-09,200.0,0.0,17961.09,2021-11-09,Tuesday,11,Nov
2021-11-09,200.0,0.0,17761.09,2021-11-09,Tuesday,11,Nov
2021-11-09,1500.0,0.0,16261.09,2021-11-09,Tuesday,11,Nov
2021-11-09,10.0,0.0,16251.09,2021-11-09,Tuesday,11,Nov
2021-11-09,0.75,0.0,16250.34,2021-11-09,Tuesday,11,Nov
2021-11-09,1200.0,0.0,15050.34,2021-11-09,Tuesday,11,Nov
2021-11-09,700.0,0.0,14350.34,2021-11-09,Tuesday,11,Nov
2021-11-09,7000.0,0.0,7350.34,2021-11-09,Tuesday,11,Nov
2021-11-09,25.0,0.0,7325.34,2021-11-09,Tuesday,11,Nov
2021-11-09,1.87,0.0,7323.47,2021-11-09,Tuesday,11,Nov
2021-11-09,700.0,0.0,6623.47,2021-11-09,Tuesday,11,Nov
2021-11-09,1000.0,0.0,5623.47,2021-11-09,Tuesday,11,Nov
2021-11-09,10.0,0.0,5613.47,2021-11-09,Tuesday,11,Nov
2021-11-09,0.75,0.0,5612.72,2021-11-09,Tuesday,11,Nov
2021-11-10,200.0,0.0,5412.72,2021-11-10,Wednesday,11,Nov
2021-11-10,2000.0,0.0,3412.72,2021-11-10,Wednesday,11,Nov
2021-11-10,10.0,0.0,3402.72,2021-11-10,Wednesday,11,Nov
2021-11-10,0.75,0.0,3401.97,2021-11-10,Wednesday,11,Nov
2021-11-10,2.0,0.0,3399.97,2021-11-10,Wednesday,11,Nov
2021-11-10,0.0,2.0,3401.97,2021-11-10,Wednesday,11,Nov
2021-11-10,2.0,0.0,3399.97,2021-11-10,Wednesday,11,Nov
2021-11-10,0.0,500.0,3899.97,2021-11-10,Wednesday,11,Nov
2021-11-10,2.0,0.0,3897.97,2021-11-10,Wednesday,11,Nov
2021-11-10,0.0,2.0,3899.97,2021-11-10,Wednesday,11,Nov
2021-11-10,450.0,0.0,3449.97,2021-11-10,Wednesday,11,Nov
2021-11-10,0.0,2.0,3451.97,2021-11-10,Wednesday,11,Nov
2021-11-10,100.0,0.0,3351.97,2021-11-10,Wednesday,11,Nov
2021-11-10,0.0,1000.0,4351.97,2021-11-10,Wednesday,11,Nov
2021-11-10,2.0,0.0,4349.97,2021-11-10,Wednesday,11,Nov
2021-11-10,0.0,2.0,4351.97,2021-11-10,Wednesday,11,Nov
2021-11-10,450.0,0.0,3901.97,2021-11-10,Wednesday,11,Nov
2021-11-10,100.0,0.0,3801.97,2021-11-10,Wednesday,11,Nov
2021-11-11,100.0,0.0,3701.97,2021-11-11,Thursday,11,Nov
2021-11-11,1000.0,0.0,2701.97,2021-11-11,Thursday,11,Nov
2021-11-11,1100.0,0.0,1601.97,2021-11-11,Thursday,11,Nov
2021-11-11,200.0,0.0,1401.97,2021-11-11,Thursday,11,Nov
2021-11-11,200.0,0.0,1201.97,2021-11-11,Thursday,11,Nov
2021-11-11,100.0,0.0,1101.97,2021-11-11,Thursday,11,Nov
2021-11-12,0.0,191487.0,192588.97,2021-11-12,Friday,11,Nov
2021-11-12,500.0,0.0,192088.97,2021-11-12,Friday,11,Nov
2021-11-12,1000.0,0.0,191088.97,2021-11-12,Friday,11,Nov
2021-11-12,500.0,0.0,190588.97,2021-11-12,Friday,11,Nov
2021-11-12,0.0,17000.0,207588.97,2021-11-12,Friday,11,Nov
2021-11-12,10000.0,0.0,197588.97,2021-11-12,Friday,11,Nov
2021-11-12,25.0,0.0,197563.97,2021-11-12,Friday,11,Nov
2021-11-12,1.87,0.0,197562.1,2021-11-12,Friday,11,Nov
2021-11-12,190000.0,0.0,7562.1,2021-11-12,Friday,11,Nov
2021-11-12,50.0,0.0,7512.1,2021-11-12,Friday,11,Nov
2021-11-12,3.75,0.0,7508.35,2021-11-12,Friday,11,Nov
2021-11-12,5000.0,0.0,2508.35,2021-11-12,Friday,11,Nov
2021-11-12,10.0,0.0,2498.35,2021-11-12,Friday,11,Nov
2021-11-12,0.75,0.0,2497.6,2021-11-12,Friday,11,Nov
2021-11-12,0.0,30000.01,32497.61,2021-11-12,Friday,11,Nov
2021-11-12,150.0,0.0,32347.61,2021-11-12,Friday,11,Nov
2021-11-13,9600.0,0.0,22747.61,2021-11-13,Saturday,11,Nov
2021-11-13,800.0,0.0,21947.61,2021-11-13,Saturday,11,Nov
2021-11-13,1500.0,0.0,20447.61,2021-11-13,Saturday,11,Nov
2021-11-13,10.0,0.0,20437.61,2021-11-13,Saturday,11,Nov
2021-11-13,0.75,0.0,20436.86,2021-11-13,Saturday,11,Nov
2021-11-13,0.0,30000.0,50436.86,2021-11-13,Saturday,11,Nov
2021-11-13,2500.0,0.0,47936.86,2021-11-13,Saturday,11,Nov
2021-11-13,2000.0,0.0,45936.86,2021-11-13,Saturday,11,Nov
2021-11-13,10.0,0.0,45926.86,2021-11-13,Saturday,11,Nov
2021-11-13,0.75,0.0,45926.11,2021-11-13,Saturday,11,Nov
2021-11-13,50.0,0.0,45876.11,2021-11-13,Saturday,11,Nov
2021-11-15,200.0,0.0,45676.11,2021-11-15,Monday,11,Nov
2021-11-15,100.0,0.0,45576.11,2021-11-15,Monday,11,Nov
2021-11-15,18000.0,0.0,27576.11,2021-11-15,Monday,11,Nov
2021-11-15,100.0,0.0,27476.11,2021-11-15,Monday,11,Nov
2021-11-15,500.0,0.0,26976.11,2021-11-15,Monday,11,Nov
2021-11-15,0.0,200000.0,226976.11,2021-11-15,Monday,11,Nov
2021-11-15,5000.0,0.0,221976.11,2021-11-15,Monday,11,Nov
2021-11-15,0.0,100000.0,321976.11,2021-11-15,Monday,11,Nov
2021-11-15,600.0,0.0,321376.11,2021-11-15,Monday,11,Nov
2021-11-15,20000.0,0.0,301376.11,2021-11-15,Monday,11,Nov
2021-11-15,25.0,0.0,301351.11,2021-11-15,Monday,11,Nov
2021-11-15,1.87,0.0,301349.24,2021-11-15,Monday,11,Nov
2021-11-15,200000.0,0.0,101349.24,2021-11-15,Monday,11,Nov
2021-11-15,50.0,0.0,101299.24,2021-11-15,Monday,11,Nov
2021-11-15,3.75,0.0,101295.49,2021-11-15,Monday,11,Nov
2021-11-15,1000.0,0.0,100295.49,2021-11-15,Monday,11,Nov
2021-11-15,10.0,0.0,100285.49,2021-11-15,Monday,11,Nov
2021-11-15,0.75,0.0,100284.74,2021-11-15,Monday,11,Nov
2021-11-15,7300.0,0.0,92984.74,2021-11-15,Monday,11,Nov
2021-11-15,25.0,0.0,92959.74,2021-11-15,Monday,11,Nov
2021-11-15,1.87,0.0,92957.87,2021-11-15,Monday,11,Nov
2021-11-15,2000.0,0.0,90957.87,2021-11-15,Monday,11,Nov
2021-11-15,20.0,0.0,90937.87,2021-11-15,Monday,11,Nov
2021-11-15,1.5,0.0,90936.37,2021-11-15,Monday,11,Nov
2021-11-15,200.0,0.0,90736.37,2021-11-15,Monday,11,Nov
2021-11-15,200.0,0.0,90536.37,2021-11-15,Monday,11,Nov
2021-11-15,5200.0,0.0,85336.37,2021-11-15,Monday,11,Nov
2021-11-15,25.0,0.0,85311.37,2021-11-15,Monday,11,Nov
2021-11-15,1.87,0.0,85309.5,2021-11-15,Monday,11,Nov
2021-11-16,100.0,0.0,85209.5,2021-11-16,Tuesday,11,Nov
2021-11-16,1300.0,0.0,83909.5,2021-11-16,Tuesday,11,Nov
2021-11-16,10000.0,0.0,73909.5,2021-11-16,Tuesday,11,Nov
2021-11-16,25.0,0.0,73884.5,2021-11-16,Tuesday,11,Nov
2021-11-16,1.87,0.0,73882.63,2021-11-16,Tuesday,11,Nov
2021-11-16,5500.0,0.0,68382.63,2021-11-16,Tuesday,11,Nov
2021-11-16,20.0,0.0,68362.63,2021-11-16,Tuesday,11,Nov
2021-11-16,1.5,0.0,68361.13,2021-11-16,Tuesday,11,Nov
2021-11-16,10000.0,0.0,58361.13,2021-11-16,Tuesday,11,Nov
2021-11-16,25.0,0.0,58336.13,2021-11-16,Tuesday,11,Nov
2021-11-16,1.87,0.0,58334.26,2021-11-16,Tuesday,11,Nov
2021-11-16,2000.0,0.0,56334.26,2021-11-16,Tuesday,11,Nov
2021-11-16,10.0,0.0,56324.26,2021-11-16,Tuesday,11,Nov
2021-11-16,0.75,0.0,56323.51,2021-11-16,Tuesday,11,Nov
2021-11-16,1000.0,0.0,55323.51,2021-11-16,Tuesday,11,Nov
2021-11-16,10.0,0.0,55313.51,2021-11-16,Tuesday,11,Nov
2021-11-16,0.75,0.0,55312.76,2021-11-16,Tuesday,11,Nov
2021-11-16,50000.0,0.0,5312.76,2021-11-16,Tuesday,11,Nov
2021-11-16,25.0,0.0,5287.76,2021-11-16,Tuesday,11,Nov
2021-11-16,1.87,0.0,5285.89,2021-11-16,Tuesday,11,Nov
2021-11-16,500.0,0.0,4785.89,2021-11-16,Tuesday,11,Nov
2021-11-16,2000.0,0.0,2785.89,2021-11-16,Tuesday,11,Nov
2021-11-16,10.0,0.0,2775.89,2021-11-16,Tuesday,11,Nov
2021-11-16,0.75,0.0,2775.14,2021-11-16,Tuesday,11,Nov
2021-11-16,200.0,0.0,2575.14,2021-11-16,Tuesday,11,Nov
2021-11-17,500.0,0.0,2075.14,2021-11-17,Wednesday,11,Nov
2021-11-18,1000.0,0.0,1075.14,2021-11-18,Thursday,11,Nov
2021-11-18,500.0,0.0,575.14,2021-11-18,Thursday,11,Nov
2021-11-19,100.0,0.0,475.14,2021-11-19,Friday,11,Nov
2021-11-19,0.0,428650.0,429125.14,2021-11-19,Friday,11,Nov
2021-11-19,75000.0,0.0,354125.14,2021-11-19,Friday,11,Nov
2021-11-19,3000.0,0.0,351125.14,2021-11-19,Friday,11,Nov
2021-11-19,10.0,0.0,351115.14,2021-11-19,Friday,11,Nov
2021-11-19,0.75,0.0,351114.39,2021-11-19,Friday,11,Nov
2021-11-19,300000.0,0.0,51114.39,2021-11-19,Friday,11,Nov
2021-11-19,50.0,0.0,51064.39,2021-11-19,Friday,11,Nov
2021-11-19,3.75,0.0,51060.64,2021-11-19,Friday,11,Nov
2021-11-19,20000.0,0.0,31060.64,2021-11-19,Friday,11,Nov
2021-11-19,500.0,0.0,30560.64,2021-11-19,Friday,11,Nov
2021-11-19,500.0,0.0,30060.64,2021-11-19,Friday,11,Nov
2021-11-19,50.0,0.0,30010.64,2021-11-19,Friday,11,Nov
2021-11-20,200.0,0.0,29810.64,2021-11-20,Saturday,11,Nov
2021-11-20,300.0,0.0,29510.64,2021-11-20,Saturday,11,Nov
2021-11-20,10000.0,0.0,19510.64,2021-11-20,Saturday,11,Nov
2021-11-20,0.0,12500.0,32010.64,2021-11-20,Saturday,11,Nov
2021-11-20,0.0,5000.0,37010.64,2021-11-20,Saturday,11,Nov
2021-11-20,0.0,22500.0,59510.64,2021-11-20,Saturday,11,Nov
2021-11-20,0.0,32500.0,92010.64,2021-11-20,Saturday,11,Nov
2021-11-20,0.0,11000.0,103010.64,2021-11-20,Saturday,11,Nov
2021-11-20,0.0,5000.0,108010.64,2021-11-20,Saturday,11,Nov
2021-11-20,100000.0,0.0,8010.64,2021-11-20,Saturday,11,Nov
2021-11-20,50.0,0.0,7960.64,2021-11-20,Saturday,11,Nov
2021-11-20,3.75,0.0,7956.89,2021-11-20,Saturday,11,Nov
2021-11-20,200.0,0.0,7756.89,2021-11-20,Saturday,11,Nov
2021-11-20,200.0,0.0,7556.89,2021-11-20,Saturday,11,Nov
2021-11-21,6000.0,0.0,1556.89,2021-11-21,Sunday,11,Nov
2021-11-21,25.0,0.0,1531.89,2021-11-21,Sunday,11,Nov
2021-11-21,1.87,0.0,1530.02,2021-11-21,Sunday,11,Nov
2021-11-21,900.0,0.0,630.02,2021-11-21,Sunday,11,Nov
2021-11-21,100.0,0.0,530.02,2021-11-21,Sunday,11,Nov
2021-11-23,0.0,1400000.0,1400530.02,2021-11-23,Tuesday,11,Nov
2021-11-23,3000.0,0.0,1397530.02,2021-11-23,Tuesday,11,Nov
2021-11-23,20.0,0.0,1397510.02,2021-11-23,Tuesday,11,Nov
2021-11-23,1.5,0.0,1397508.52,2021-11-23,Tuesday,11,Nov
2021-11-23,200.0,0.0,1397308.52,2021-11-23,Tuesday,11,Nov
2021-11-23,50.0,0.0,1397258.52,2021-11-23,Tuesday,11,Nov
2021-11-24,500.0,0.0,1396758.52,2021-11-24,Wednesday,11,Nov
2021-11-24,1300000.0,0.0,96758.52,2021-11-24,Wednesday,11,Nov
2021-11-24,50.0,0.0,96708.52,2021-11-24,Wednesday,11,Nov
2021-11-24,3.75,0.0,96704.77,2021-11-24,Wednesday,11,Nov
2021-11-24,0.0,1300000.0,1396704.77,2021-11-24,Wednesday,11,Nov
2021-11-24,0.0,50.0,1396754.77,2021-11-24,Wednesday,11,Nov
2021-11-24,0.0,3.75,1396758.52,2021-11-24,Wednesday,11,Nov
2021-11-24,1350000.0,0.0,46758.52,2021-11-24,Wednesday,11,Nov
2021-11-24,50.0,0.0,46708.52,2021-11-24,Wednesday,11,Nov
2021-11-24,3.75,0.0,46704.77,2021-11-24,Wednesday,11,Nov
2021-11-25,300.0,0.0,46404.77,2021-11-25,Thursday,11,Nov
2021-11-25,40000.0,0.0,6404.77,2021-11-25,Thursday,11,Nov
2021-11-25,25.0,0.0,6379.77,2021-11-25,Thursday,11,Nov
2021-11-25,1.87,0.0,6377.9,2021-11-25,Thursday,11,Nov
2021-11-25,0.0,1700.0,8077.9,2021-11-25,Thursday,11,Nov
2021-11-25,5000.0,0.0,3077.9,2021-11-25,Thursday,11,Nov
2021-11-25,200.0,0.0,2877.9,2021-11-25,Thursday,11,Nov
2021-11-25,200.0,0.0,2677.9,2021-11-25,Thursday,11,Nov
2021-11-25,200.0,0.0,2477.9,2021-11-25,Thursday,11,Nov
2021-11-26,900.0,0.0,1577.9,2021-11-26,Friday,11,Nov
2021-11-26,900.0,0.0,677.9,2021-11-26,Friday,11,Nov
2021-11-26,100.0,0.0,577.9,2021-11-26,Friday,11,Nov
2021-11-27,577.9,0.0,0.0,2021-11-27,Saturday,11,Nov
2021-11-27,0.0,179900.0,179900.0,2021-11-27,Saturday,11,Nov
2021-11-27,5000.0,0.0,174900.0,2021-11-27,Saturday,11,Nov
2021-11-27,1000.0,0.0,173900.0,2021-11-27,Saturday,11,Nov
2021-11-27,30000.0,0.0,143900.0,2021-11-27,Saturday,11,Nov
2021-11-27,25.0,0.0,143875.0,2021-11-27,Saturday,11,Nov
2021-11-27,1.87,0.0,143873.13,2021-11-27,Saturday,11,Nov
2021-11-27,200.0,0.0,143673.13,2021-11-27,Saturday,11,Nov
2021-11-27,50.0,0.0,143623.13,2021-11-27,Saturday,11,Nov
2021-11-28,2000.0,0.0,141623.13,2021-11-28,Sunday,11,Nov
2021-11-28,10.0,0.0,141613.13,2021-11-28,Sunday,11,Nov
2021-11-28,0.75,0.0,141612.38,2021-11-28,Sunday,11,Nov
2021-11-28,200.0,0.0,141412.38,2021-11-28,Sunday,11,Nov
2021-11-28,130000.0,0.0,11412.38,2021-11-28,Sunday,11,Nov
2021-11-28,50.0,0.0,11362.38,2021-11-28,Sunday,11,Nov
2021-11-28,3.75,0.0,11358.63,2021-11-28,Sunday,11,Nov
2021-11-28,200.0,0.0,11158.63,2021-11-28,Sunday,11,Nov
2021-11-28,4000.0,0.0,7158.63,2021-11-28,Sunday,11,Nov
2021-11-28,10.0,0.0,7148.63,2021-11-28,Sunday,11,Nov
2021-11-28,0.75,0.0,7147.88,2021-11-28,Sunday,11,Nov
2021-11-29,100.0,0.0,7047.88,2021-11-29,Monday,11,Nov
2021-11-29,1000.0,0.0,6047.88,2021-11-29,Monday,11,Nov
2021-11-29,0.0,600.0,6647.88,2021-11-29,Monday,11,Nov
2021-11-30,5000.0,0.0,1647.88,2021-11-30,Tuesday,11,Nov
2021-11-30,200.0,0.0,1447.88,2021-11-30,Tuesday,11,Nov
2021-11-30,200.0,0.0,1247.88,2021-11-30,Tuesday,11,Nov
2021-12-06,0.0,10000.0,11247.88,2021-12-06,Monday,12,Dec
2021-12-07,50.0,0.0,11197.88,2021-12-07,Tuesday,12,Dec
2021-12-07,200.0,0.0,10997.88,2021-12-07,Tuesday,12,Dec
2021-12-07,200.0,0.0,10797.88,2021-12-07,Tuesday,12,Dec
2021-12-07,0.0,1800000.0,1810797.88,2021-12-07,Tuesday,12,Dec
2021-12-07,0.0,200000.0,2010797.88,2021-12-07,Tuesday,12,Dec
2021-12-07,2000000.0,0.0,10797.88,2021-12-07,Tuesday,12,Dec
2021-12-07,50.0,0.0,10747.88,2021-12-07,Tuesday,12,Dec
2021-12-07,3.75,0.0,10744.13,2021-12-07,Tuesday,12,Dec
2021-12-07,200.0,0.0,10544.13,2021-12-07,Tuesday,12,Dec
2021-12-08,100.0,0.0,10444.13,2021-12-08,Wednesday,12,Dec
2021-12-08,10000.0,0.0,444.13,2021-12-08,Wednesday,12,Dec
2021-12-08,200.0,0.0,244.13,2021-12-08,Wednesday,12,Dec
2021-12-08,0.0,100000.0,100244.13,2021-12-08,Wednesday,12,Dec
2021-12-08,200.0,0.0,100044.13,2021-12-08,Wednesday,12,Dec
2021-12-08,14000.0,0.0,86044.13,2021-12-08,Wednesday,12,Dec
2021-12-08,25.0,0.0,86019.13,2021-12-08,Wednesday,12,Dec
2021-12-08,1.87,0.0,86017.26,2021-12-08,Wednesday,12,Dec
2021-12-08,500.0,0.0,85517.26,2021-12-08,Wednesday,12,Dec
2021-12-08,3000.0,0.0,82517.26,2021-12-08,Wednesday,12,Dec
2021-12-08,10.0,0.0,82507.26,2021-12-08,Wednesday,12,Dec
2021-12-08,0.75,0.0,82506.51,2021-12-08,Wednesday,12,Dec
2021-12-08,50000.0,0.0,32506.51,2021-12-08,Wednesday,12,Dec
2021-12-08,25.0,0.0,32481.51,2021-12-08,Wednesday,12,Dec
2021-12-08,1.87,0.0,32479.64,2021-12-08,Wednesday,12,Dec
2021-12-08,0.0,55000.0,87479.64,2021-12-08,Wednesday,12,Dec
2021-12-08,5000.0,0.0,82479.64,2021-12-08,Wednesday,12,Dec
2021-12-08,10.0,0.0,82469.64,2021-12-08,Wednesday,12,Dec
2021-12-08,0.75,0.0,82468.89,2021-12-08,Wednesday,12,Dec
2021-12-08,1500.0,0.0,80968.89,2021-12-08,Wednesday,12,Dec
2021-12-08,10.0,0.0,80958.89,2021-12-08,Wednesday,12,Dec
2021-12-08,0.75,0.0,80958.14,2021-12-08,Wednesday,12,Dec
2021-12-08,10000.0,0.0,70958.14,2021-12-08,Wednesday,12,Dec
2021-12-08,25.0,0.0,70933.14,2021-12-08,Wednesday,12,Dec
2021-12-08,1.87,0.0,70931.27,2021-12-08,Wednesday,12,Dec
2021-12-08,10000.0,0.0,60931.27,2021-12-08,Wednesday,12,Dec
2021-12-08,25.0,0.0,60906.27,2021-12-08,Wednesday,12,Dec
2021-12-08,1.87,0.0,60904.4,2021-12-08,Wednesday,12,Dec
2021-12-08,60000.0,0.0,904.4,2021-12-08,Wednesday,12,Dec
2021-12-08,50.0,0.0,854.4,2021-12-08,Wednesday,12,Dec
2021-12-08,3.75,0.0,850.65,2021-12-08,Wednesday,12,Dec
2021-12-08,200.0,0.0,650.65,2021-12-08,Wednesday,12,Dec
2021-12-08,0.0,10000.0,10650.65,2021-12-08,Wednesday,12,Dec
2021-12-08,100.0,0.0,10550.65,2021-12-08,Wednesday,12,Dec
2021-12-09,2000.0,0.0,8550.65,2021-12-09,Thursday,12,Dec
2021-12-09,10.0,0.0,8540.65,2021-12-09,Thursday,12,Dec
2021-12-09,0.75,0.0,8539.9,2021-12-09,Thursday,12,Dec
2021-12-09,4000.0,0.0,4539.9,2021-12-09,Thursday,12,Dec
2021-12-09,10.0,0.0,4529.9,2021-12-09,Thursday,12,Dec
2021-12-09,0.75,0.0,4529.15,2021-12-09,Thursday,12,Dec
2021-12-09,0.0,10000.0,14529.15,2021-12-09,Thursday,12,Dec
2021-12-09,10000.0,0.0,4529.15,2021-12-09,Thursday,12,Dec
2021-12-09,20.0,0.0,4509.15,2021-12-09,Thursday,12,Dec
2021-12-09,1.5,0.0,4507.65,2021-12-09,Thursday,12,Dec
2021-12-09,2000.0,0.0,2507.65,2021-12-09,Thursday,12,Dec
2021-12-09,10.0,0.0,2497.65,2021-12-09,Thursday,12,Dec
2021-12-09,0.75,0.0,2496.9,2021-12-09,Thursday,12,Dec
2021-12-09,500.0,0.0,1996.9,2021-12-09,Thursday,12,Dec
2021-12-09,50.0,0.0,1946.9,2021-12-09,Thursday,12,Dec
2021-12-10,0.0,20000.0,21946.9,2021-12-10,Friday,12,Dec
2021-12-10,0.0,20000.0,41946.9,2021-12-10,Friday,12,Dec
2021-12-10,0.0,20000.0,61946.9,2021-12-10,Friday,12,Dec
2021-12-10,0.0,20000.0,81946.9,2021-12-10,Friday,12,Dec
2021-12-10,2000.0,0.0,79946.9,2021-12-10,Friday,12,Dec
2021-12-10,10.0,0.0,79936.9,2021-12-10,Friday,12,Dec
2021-12-10,0.75,0.0,79936.15,2021-12-10,Friday,12,Dec
2021-12-10,70000.0,0.0,9936.15,2021-12-10,Friday,12,Dec
2021-12-10,50.0,0.0,9886.15,2021-12-10,Friday,12,Dec
2021-12-10,3.75,0.0,9882.4,2021-12-10,Friday,12,Dec
2021-12-10,1900.0,0.0,7982.4,2021-12-10,Friday,12,Dec
2021-12-10,2300.0,0.0,5682.4,2021-12-10,Friday,12,Dec
2021-12-10,10.0,0.0,5672.4,2021-12-10,Friday,12,Dec
2021-12-10,0.75,0.0,5671.65,2021-12-10,Friday,12,Dec
2021-12-10,2000.0,0.0,3671.65,2021-12-10,Friday,12,Dec
2021-12-10,10.0,0.0,3661.65,2021-12-10,Friday,12,Dec
2021-12-10,0.75,0.0,3660.9,2021-12-10,Friday,12,Dec
2021-12-10,500.0,0.0,3160.9,2021-12-10,Friday,12,Dec
2021-12-11,200.0,0.0,2960.9,2021-12-11,Saturday,12,Dec
2021-12-11,100.0,0.0,2860.9,2021-12-11,Saturday,12,Dec
2021-12-12,900.0,0.0,1960.9,2021-12-12,Sunday,12,Dec
2021-12-12,1600.0,0.0,360.9,2021-12-12,Sunday,12,Dec
2021-12-13,0.0,2300.0,2660.9,2021-12-13,Monday,12,Dec
2021-12-13,2000.0,0.0,660.9,2021-12-13,Monday,12,Dec
2021-12-13,200.0,0.0,460.9,2021-12-13,Monday,12,Dec
2021-12-16,0.0,117400.0,117860.9,2021-12-16,Thursday,12,Dec
2021-12-16,100000.0,0.0,17860.9,2021-12-16,Thursday,12,Dec
2021-12-16,50.0,0.0,17810.9,2021-12-16,Thursday,12,Dec
2021-12-16,3.75,0.0,17807.15,2021-12-16,Thursday,12,Dec
2021-12-16,15000.0,0.0,2807.15,2021-12-16,Thursday,12,Dec
2021-12-16,25.0,0.0,2782.15,2021-12-16,Thursday,12,Dec
2021-12-16,1.87,0.0,2780.28,2021-12-16,Thursday,12,Dec
2021-12-16,200.0,0.0,2580.28,2021-12-16,Thursday,12,Dec
2021-12-16,300.0,0.0,2280.28,2021-12-16,Thursday,12,Dec
2021-12-16,50.0,0.0,2230.28,2021-12-16,Thursday,12,Dec
2021-12-17,0.0,10000.0,12230.28,2021-12-17,Friday,12,Dec
2021-12-17,100.0,0.0,12130.28,2021-12-17,Friday,12,Dec
2021-12-17,50.0,0.0,12080.28,2021-12-17,Friday,12,Dec
2021-12-18,1100.0,0.0,10980.28,2021-12-18,Saturday,12,Dec
2021-12-18,100.0,0.0,10880.28,2021-12-18,Saturday,12,Dec
2021-12-18,0.0,1500.0,12380.28,2021-12-18,Saturday,12,Dec
2021-12-18,1200.0,0.0,11180.28,2021-12-18,Saturday,12,Dec
2021-12-18,100.0,0.0,11080.28,2021-12-18,Saturday,12,Dec
2021-12-19,0.0,2000.0,13080.28,2021-12-19,Sunday,12,Dec
2021-12-19,10000.0,0.0,3080.28,2021-12-19,Sunday,12,Dec
2021-12-20,200.0,0.0,2880.28,2021-12-20,Monday,12,Dec
2021-12-20,0.0,130290.0,133170.28,2021-12-20,Monday,12,Dec
2021-12-20,0.0,1898.8,135069.08,2021-12-20,Monday,12,Dec
2021-12-20,100000.0,0.0,35069.08,2021-12-20,Monday,12,Dec
2021-12-20,50.0,0.0,35019.08,2021-12-20,Monday,12,Dec
2021-12-20,3.75,0.0,35015.33,2021-12-20,Monday,12,Dec
2021-12-20,31000.0,0.0,4015.33,2021-12-20,Monday,12,Dec
2021-12-20,25.0,0.0,3990.33,2021-12-20,Monday,12,Dec
2021-12-20,1.87,0.0,3988.46,2021-12-20,Monday,12,Dec
2021-12-20,500.0,0.0,3488.46,2021-12-20,Monday,12,Dec
2021-12-20,200.0,0.0,3288.46,2021-12-20,Monday,12,Dec
2021-12-21,1500.0,0.0,1788.46,2021-12-21,Tuesday,12,Dec
2021-12-21,900.0,0.0,888.46,2021-12-21,Tuesday,12,Dec
2021-12-21,300.0,0.0,588.46,2021-12-21,Tuesday,12,Dec
2021-12-21,100.0,0.0,488.46,2021-12-21,Tuesday,12,Dec
2021-12-24,0.0,2200.0,2688.46,2021-12-24,Friday,12,Dec
2021-12-24,2000.0,0.0,688.46,2021-12-24,Friday,12,Dec
2021-12-24,20.0,0.0,668.46,2021-12-24,Friday,12,Dec
2021-12-24,1.5,0.0,666.96,2021-12-24,Friday,12,Dec
2021-12-24,0.0,2000.0,2666.96,2021-12-24,Friday,12,Dec
2021-12-24,0.0,20.0,2686.96,2021-12-24,Friday,12,Dec
2021-12-24,0.0,1.5,2688.46,2021-12-24,Friday,12,Dec
2021-12-24,2100.0,0.0,588.46,2021-12-24,Friday,12,Dec
2021-12-29,392.0,0.0,196.46,2021-12-29,Wednesday,12,Dec
2021-12-29,29.4,0.0,167.06,2021-12-29,Wednesday,12,Dec
2021-12-31,0.0,1000.0,1167.06,2021-12-31,Friday,12,Dec
2022-01-04,100.0,0.0,1067.06,2022-01-04,Tuesday,1,Jan
2022-01-06,1000.0,0.0,67.06,2022-01-06,Thursday,1,Jan
2022-01-07,0.0,180000.0,180067.06,2022-01-07,Friday,1,Jan
2022-01-07,43000.0,0.0,137067.06,2022-01-07,Friday,1,Jan
2022-01-07,100000.0,0.0,37067.06,2022-01-07,Friday,1,Jan
2022-01-07,50.0,0.0,37017.06,2022-01-07,Friday,1,Jan
2022-01-07,3.75,0.0,37013.31,2022-01-07,Friday,1,Jan
2022-01-07,2000.0,0.0,35013.31,2022-01-07,Friday,1,Jan
2022-01-07,1350.0,0.0,33663.31,2022-01-07,Friday,1,Jan
2022-01-07,10.0,0.0,33653.31,2022-01-07,Friday,1,Jan
2022-01-07,0.75,0.0,33652.56,2022-01-07,Friday,1,Jan
2022-01-07,500.0,0.0,33152.56,2022-01-07,Friday,1,Jan
2022-01-07,500.0,0.0,32652.56,2022-01-07,Friday,1,Jan
2022-01-08,50.0,0.0,32602.56,2022-01-08,Saturday,1,Jan
2022-01-08,17100.0,0.0,15502.56,2022-01-08,Saturday,1,Jan
2022-01-08,25.0,0.0,15477.56,2022-01-08,Saturday,1,Jan
2022-01-08,1.87,0.0,15475.69,2022-01-08,Saturday,1,Jan
2022-01-08,200.0,0.0,15275.69,2022-01-08,Saturday,1,Jan
2022-01-09,900.0,0.0,14375.69,2022-01-09,Sunday,1,Jan
2022-01-09,900.0,0.0,13475.69,2022-01-09,Sunday,1,Jan
2022-01-09,1100.0,0.0,12375.69,2022-01-09,Sunday,1,Jan
2022-01-09,10000.0,0.0,2375.69,2022-01-09,Sunday,1,Jan
2022-01-09,200.0,0.0,2175.69,2022-01-09,Sunday,1,Jan
2022-01-09,100.0,0.0,2075.69,2022-01-09,Sunday,1,Jan
